stachydrine	CMUNUTVVOOHQPW-UHFFFAOYSA-N	CMUNUTVVOOHQPW-LURJTMIESA-N
loracarbef	JAPHQRWPEGVNBT-UTUOFQBUSA-M	JAPHQRWPEGVNBT-UTUOFQBUSA-N	GPYKKBAAPVOCIW-HSASPSRMSA-N	JAPHQRWPEGVNBT-UTUOFQBUSA-N
cefapirin	UQLLWWBDSUHNEB-CZUORRHYSA-N
calycanthine	XSYCDVWYEVUDKQ-GXRSIYKFSA-N	XSYCDVWYEVUDKQ-FNAHDJPLSA-N	XSYCDVWYEVUDKQ-UHFFFAOYSA-N
pridinol	RQXCLMGKHJWMOA-UHFFFAOYSA-N
biotin	YBJHBAHKTGYVGT-ZKWXMUAHSA-N
coralyne	PDYBUYVOPAJLKP-UHFFFAOYSA-M
molsidomine	XLFWDASMENKTKL-UHFFFAOYSA-N
yohimbic_acid	
phenanthridinone	IHYKUAAWZFJGJJ-UHFFFAOYSA-N
cinchocaine	PUFQVTATUTYEAL-UHFFFAOYSA-N
haloperidol	LNEPOXFFQSENCJ-UHFFFAOYSA-N
nystatin	VQOXZBDYSJBXMA-APKAJEQISA-N	VQOXZBDYSJBXMA-PNHDYXCYSA-N	VQOXZBDYSJBXMA-QVAIYGMRSA-N	VQOXZBDYSJBXMA-WRDWGCENSA-N	ZDFDJJJGIRGMBE-AFARJNEBSA-N	ZDFDJJJGIRGMBE-UHFFFAOYSA-N	IJTNSXPMYKJZPR-UHFFFAOYSA-N	SZYDXHPNWBHUAD-UHBGQPKLSA-N	VQOXZBDYSJBXMA-NQTDYLQESA-N	ZDFDJJJGIRGMBE-GGHLNKJMSA-N	IKYMLQOHQLVORI-PLAPNZKPSA-N	PFADFVCWHVCPLV-PISACPBCSA-N	ZDFDJJJGIRGMBE-YMRVYQTRSA-N	VQOXZBDYSJBXMA-ISCGSDQNSA-N	IKYMLQOHQLVORI-HSTSHOJBSA-N	ZYYCHNFSUYYLTP-HWEHLMELSA-N	VQOXZBDYSJBXMA-QEKUPDCNSA-N	VQOXZBDYSJBXMA-VNGPISPUSA-N	VQOXZBDYSJBXMA-RKEBNKJGSA-N	VQOXZBDYSJBXMA-VHFLTRTASA-N	TZGGGAABSYEBCH-BPYTUWLESA-N
sulfaquinoxaline	NHZLNPMOSADWGC-UHFFFAOYSA-N
MS-275	INVTYAOGFAGBOE-UHFFFAOYSA-N
propofol	OLBCVFGFOZPWHH-UHFFFAOYSA-N
orphenadrine	QVYRGXJJSLMXQH-UHFFFAOYSA-N
arcaine	HGMDNMBBCKDWTQ-UHFFFAOYSA-N
H-7	BDVFVCGFMNCYPV-UHFFFAOYSA-N
citiolone	NRFJZTXWLKPZAV-UHFFFAOYSA-N
gemfibrozil	HEMJJKBWTPKOJG-UHFFFAOYSA-N
saquinavir	QWAXKHKRTORLEM-UGJKXSETSA-N
pralidoxime	JBKPUQTUERUYQE-VOTSOKGWSA-O	HIGSLXSBYYMVKI-UHDJGPCESA-N
homochlorcyclizine	WEUCDJCFJHYFRL-UHFFFAOYSA-N
guanabenz	WDZVGELJXXEGPV-YIXHJXPBSA-N
tolazamide	OUDSBRTVNLOZBN-UHFFFAOYSA-N
diprophylline	KSCFJBIXMNOVSH-UHFFFAOYSA-N
sotalol	ZBMZVLHSJCTVON-UHFFFAOYSA-N
paclitaxel	RCINICONZNJXQF-NVOPOYJOSA-N	RCINICONZNJXQF-POUKISRJSA-N	RCINICONZNJXQF-MZXODVADSA-N	RCINICONZNJXQF-CNCSTAFZSA-N	RCINICONZNJXQF-HMUULVQDSA-N	RCINICONZNJXQF-UHFFFAOYSA-N	RCINICONZNJXQF-VAZQATRQSA-N	RCINICONZNJXQF-PKCHNARUSA-N
fluticasone	MGNNYOODZCAHBA-GQKYHHCASA-N
vitexin	SGEWCQFRYRRZDC-VPRICQMDSA-N
dexpanthenol	SNPLKNRPJHDVJA-ZETCQYMHSA-N	SNPLKNRPJHDVJA-UHFFFAOYSA-N
cyclic_adenosine_monophosphate	
methoxamine	WJAJPNHVVFWKKL-UHFFFAOYSA-N
carbinoxamine	OJFSXZCBGQGRNV-UHFFFAOYSA-N
xylazine	BPICBUSOMSTKRF-UHFFFAOYSA-N
levomepromazine	VRQVVMDWGGWHTJ-CQSZACIVSA-N
suramin_sodium	
tonzonium_bromide	
isometheptene	XVQUOJBERHHONY-UHFFFAOYSA-N
nitrofurantoin	NXFQHRVNIOXGAQ-YCRREMRBSA-N
trichostatin_A	
Leucomisine 	BJPSSVHNEGMBDQ-NUZBWSBOSA-N
acetylsalicylsalicylic_acid	
dimethyloxalylglycine	BNJOZDZCRHCODO-UHFFFAOYSA-N
pancuronium_bromide	
cyclopentolate	SKYSRIRYMSLOIN-UHFFFAOYSA-N
5114445	
nomegestrol	KZUIYQJTUIACIG-YBZCJVABSA-N
adenosine_phosphate	
etifenin	WNIDXAKKFOKNEF-UHFFFAOYSA-N
salsolidin	HMYJLVDKPJHJCF-UHFFFAOYSA-N
chloropyramine	ICKFFNBDFNZJSX-UHFFFAOYSA-N
medrysone	GZENKSODFLBBHQ-ILSZZQPISA-N
trimethobenzamide	FEZBIKUBAYAZIU-UHFFFAOYSA-N
arachidonyltrifluoromethane	PLWROONZUDKYKG-DOFZRALJSA-N
canadine	VZTUIEROBZXUFA-UHFFFAOYSA-N
monensin	GAOZTHIDHYLHMS-UHFFFAOYSA-N	GAOZTHIDHYLHMS-KEOBGNEYSA-N	GAOZTHIDHYLHMS-ZHWDXKHISA-N	GAOZTHIDHYLHMS-GDMSFIFLSA-N
Nitrocaramiphen hydrochloride	XWQWACGTGFICFO-UHFFFAOYSA-N
bromperidol	RKLNONIVDFXQRX-UHFFFAOYSA-N
isopropamide_iodide	
F0447-0125	
meclocycline	RNIADBXQDMCFEN-IWVLMIASSA-N
homosalate	WSSJONWNBBTCMG-UHFFFAOYSA-N
cefaclor	QYIYFLOTGYLRGG-GPCCPHFNSA-N
N-acetyl-L-leucine	WXNXCEHXYPACJF-ZETCQYMHSA-N
Evoxine 	FGANMDNHTVJAHL-UHFFFAOYSA-N
lynestrenol	YNVGQYHLRCDXFQ-XGXHKTLJSA-N
mepenzolate_bromide	
15-delta_prostaglandin_J2	
tiratricol	UOWZUVNAGUAEQC-UHFFFAOYSA-N
proscillaridin	MYEJFUXQJGHEQK-OWBILYANSA-N	MYEJFUXQJGHEQK-SEXHJYIHSA-N	MYEJFUXQJGHEQK-UHFFFAOYSA-N	MYEJFUXQJGHEQK-DYDCTSDLSA-N	MYEJFUXQJGHEQK-ALRJYLEOSA-N
abamectin	RRZXIRBKKLTSOM-IPRAJKPQSA-N	RRZXIRBKKLTSOM-WKRCCXHTSA-N	RRZXIRBKKLTSOM-UHFFFAOYSA-N	RRZXIRBKKLTSOM-KPWDVPTFSA-N	RRZXIRBKKLTSOM-XPNPUAGNSA-N	RRZXIRBKKLTSOM-ONDMGMIHSA-N	RRZXIRBKKLTSOM-URHDDZCMSA-N	RRZXIRBKKLTSOM-RDKIRRGNSA-N	RRZXIRBKKLTSOM-YCYJKDKUSA-N	RRZXIRBKKLTSOM-NDJJZKGWSA-N
arecoline	HJJPJSXJAXAIPN-UHFFFAOYSA-N
fluphenazine	PLDUPXSUYLZYBN-UHFFFAOYSA-N
isosorbide	KLDXJTOLSGUMSJ-JGWLITMVSA-N
maprotiline	QSLMDECMDJKHMQ-UHFFFAOYSA-N
brinzolamide	HCRKCZRJWPKOAR-JTQLQIEISA-N
5149715	
ergocalciferol	MECHNRXZTMCUDQ-DJGSNFFDSA-N	MECHNRXZTMCUDQ-ZJGOHBTISA-N	MECHNRXZTMCUDQ-DQOHKZOFSA-N	MECHNRXZTMCUDQ-UHFFFAOYSA-N	MECHNRXZTMCUDQ-VLOQVYPSSA-N	MECHNRXZTMCUDQ-CIFSABHRSA-N	MECHNRXZTMCUDQ-RKHKHRCZSA-N	MECHNRXZTMCUDQ-RVHPUGADSA-N	MECHNRXZTMCUDQ-MIQZZRNQSA-N	MECHNRXZTMCUDQ-CLTZFDELSA-N	MECHNRXZTMCUDQ-AAGLSAJLSA-N	MECHNRXZTMCUDQ-GXNDFQCXSA-N
dioxybenzone	MEZZCSHVIGVWFI-UHFFFAOYSA-N
dihydroergocristine	DEQITUUQPICUMR-HJPBWRTMSA-N	DEQITUUQPICUMR-KLANVLAUSA-N	DEQITUUQPICUMR-UHFFFAOYSA-N
piperacetazine	BTFMCMVEUCGQDX-UHFFFAOYSA-N
pirenzepine	RMHMFHUVIITRHF-UHFFFAOYSA-N
piretanide	UJEWTUDSLQGTOA-UHFFFAOYSA-N
0173570-0000	
thiamphenicol	OTVAEFIXJLOWRX-NXEZZACHSA-N
pipemidic_acid	
zalcitabine	WREGKURFCTUGRC-POYBYMJQSA-N
zimeldine	OYPPVKRFBIWMSX-SXGWCWSVSA-N
thalidomide	UEJJHQNACJXSKW-UHFFFAOYSA-N
sitosterol	KZJWDPNRJALLNS-VJSFXXLFSA-N
ramipril	HDACQVRGBOVJII-JBDAPHQKSA-N
flavoxate	SPIUTQOUKAMGCX-UHFFFAOYSA-N
carbenoxolone	OBZHEBDUNPOCJG-SMVPYXKTSA-N	OBZHEBDUNPOCJG-WZCASOPNSA-N	OBZHEBDUNPOCJG-SZTGPWMUSA-N	OBZHEBDUNPOCJG-ILYNEHRHSA-N	OBZHEBDUNPOCJG-WBXJDKIVSA-N
antazoline	REYFJDPCWQRWAA-UHFFFAOYSA-N
oxybutynin	XIQVNETUBQGFHX-UHFFFAOYSA-N
equilin	WKRLQDKEXYKHJB-HFTRVMKXSA-N
tretinoin	SHGAZHPCJJPHSC-YCNIQYBTSA-N
AG-012559	OOZXAJJTSZFCKW-UHFFFAOYSA-N
fludrocortisone	AAXVEMMRQDVLJB-BULBTXNYSA-N
riboflavin	AUNGANRZJHBGPY-MBNYWOFBSA-N	AUNGANRZJHBGPY-SCRDCRAPSA-N	AUNGANRZJHBGPY-UHFFFAOYSA-N
midecamycin	DMUAPQTXSSNEDD-QALJCMCCSA-N	DMUAPQTXSSNEDD-KTNMPIKDSA-N	DMUAPQTXSSNEDD-IWHORCFHSA-N	DMUAPQTXSSNEDD-ARNTXJTDSA-N	DMUAPQTXSSNEDD-ZZHFWOCQSA-N	DMUAPQTXSSNEDD-UHFFFAOYSA-N
piroxicam	QYSPLQLAKJAUJT-UHFFFAOYSA-N
tiabendazole	WJCNZQLZVWNLKY-UHFFFAOYSA-N
amprolium	PJBQYZZKGNOKNJ-UHFFFAOYSA-M	LCTXBFGHZLGBNU-UHFFFAOYSA-M	IPZFPROOBOUEIG-UHFFFAOYSA-N
levonorgestrel	WWYNJERNGUHSAO-XUDSTZEESA-N
exemestane	BFYIZQONLCFLEV-DAELLWKTSA-N
fluspirilene	QOYHHIBFXOOADH-UHFFFAOYSA-N
thapsigargin	IXFPJGBNCFXKPI-FSIHEZPISA-N
halcinonide	MUQNGPZZQDCDFT-JNQJZLCISA-N
natamycin	NCXMLFZGDNKEPB-QGKVIQPQSA-N	NCXMLFZGDNKEPB-ZTCXGQLRSA-N	NCXMLFZGDNKEPB-YWDKRKKXSA-N	NCXMLFZGDNKEPB-HTTLVDSYSA-N	NCXMLFZGDNKEPB-BQGNJOPGSA-N	NCXMLFZGDNKEPB-SRRZVWMPSA-N	NCXMLFZGDNKEPB-UHFFFAOYSA-N	NCXMLFZGDNKEPB-FFPOYIOWSA-N	NCXMLFZGDNKEPB-ZIEPNCTPSA-N	NCXMLFZGDNKEPB-YWLXPFDSSA-N	NCXMLFZGDNKEPB-RXKQOUODSA-N	NCXMLFZGDNKEPB-FFOAUBFKSA-N
piperine	MXXWOMGUGJBKIW-YPCIICBESA-N
cefsulodin	REACMANCWHKJSM-DWBVFMGKSA-M	REACMANCWHKJSM-WXNNVNCASA-N	SYLKGLMBLAAGSC-IKZMBGHXSA-O	REACMANCWHKJSM-UHFFFAOYSA-M	SYLKGLMBLAAGSC-QLVMHMETSA-N	SYLKGLMBLAAGSC-UHFFFAOYSA-N	SYLKGLMBLAAGSC-IKZMBGHXSA-N	REACMANCWHKJSM-WXNNVNCASA-M
tolmetin	UPSPUYADGBWSHF-UHFFFAOYSA-N
penbutolol	KQXKVJAGOJTNJS-HNNXBMFYSA-N
tyrphostin_AG-1478	
tubocurarine_chloride	
cobalt_chloride	
felbinac	QRZAKQDHEVVFRX-UHFFFAOYSA-N
ticarcillin	OHKOGUYZJXTSFX-KZFFXBSXSA-N
ciprofloxacin	MYSWGUAQZAJSOK-UHFFFAOYSA-N
vancomycin	LCTORFDMHNKUSG-XTTLPDOESA-N	MYPYJXKWCTUITO-LYRMYLQWSA-N	MYPYJXKWCTUITO-LYRMYLQWSA-P	MYPYJXKWCTUITO-LYRMYLQWSA-O
ronidazole	PQFRTXSWDXZRRS-UHFFFAOYSA-N
captopril	FAKRSMQSSFJEIM-RQJHMYQMSA-N
HC_toxin	GNYCTMYOHGBSBI-KVUCBBCISA-N
aconitine	XFSBVAOIAHNAPC-NVPFWRPTSA-N	XFSBVAOIAHNAPC-CZFAXEQISA-N	XFSBVAOIAHNAPC-FZYWAKRPSA-N	XFSBVAOIAHNAPC-BRYKFIOKSA-N	XFSBVAOIAHNAPC-XTHSEXKGSA-N	XFSBVAOIAHNAPC-UHFFFAOYSA-N	XFSBVAOIAHNAPC-WSORPINJSA-N	XFSBVAOIAHNAPC-UHVGQKBVSA-N	XFSBVAOIAHNAPC-PHLDZCGOSA-N	XFSBVAOIAHNAPC-RDWNBWGZSA-N	XFSBVAOIAHNAPC-FKHWODAVSA-N
isoxicam	YYUAYBYLJSNDCX-UHFFFAOYSA-N
sisomicin	URWAJWIAIPFPJE-YFMIWBNJSA-N
Quinic acid 	AAWZDTNXLSGCEK-LNVDRNJUSA-N
piperlongumine	VABYUUZNAVQNPG-BQYQJAHWSA-N
troleandomycin	LQCLVBQBTUVCEQ-BFKGUNNCSA-N	LQCLVBQBTUVCEQ-CLPGKMRCSA-N	LQCLVBQBTUVCEQ-RFHKDOLOSA-N	LQCLVBQBTUVCEQ-MCQAQMIOSA-N	LQCLVBQBTUVCEQ-QTFUVMRISA-N	LQCLVBQBTUVCEQ-UHFFFAOYSA-N	LQCLVBQBTUVCEQ-GSELTXNRSA-N
homatropine	ZTVIKZXZYLEVOL-DGKWVBSXSA-N	ZTVIKZXZYLEVOL-IZGVIRRGSA-N	ZTVIKZXZYLEVOL-UHFFFAOYSA-N
benzamil	KXDROGADUISDGY-UHFFFAOYSA-N
nafcillin	GPXLMGHLHQJAGZ-JTDSTZFVSA-N
fosfosal	FFKUDWZICMJVPA-UHFFFAOYSA-N
aminophylline	FQPFAHBPWDRTLU-UHFFFAOYSA-N
ceforanide	SLAYUXIURFNXPG-CRAIPNDOSA-N
amantadine	DKNWSYNQZKUICI-UHFFFAOYSA-N
pipenzolate_bromide	
buspirone	QWCRAEMEVRGPNT-UHFFFAOYSA-N
cyanocobalamin	FDJOLVPMNUYSCM-UVKKECPRSA-L	FDJOLVPMNUYSCM-UHFFFAOYSA-L	FDJOLVPMNUYSCM-QJRSUKKJSA-L	FDJOLVPMNUYSCM-WZHZPDAFSA-L	FDJOLVPMNUYSCM-UVKKECPRSA-L	AGVAZMGAQJOSFJ-UHFFFAOYSA-M	FDJOLVPMNUYSCM-UHFFFAOYSA-L	AGVAZMGAQJOSFJ-WZHZPDAFSA-M	FDJOLVPMNUYSCM-WZHZPDAFSA-L	FDJOLVPMNUYSCM-UHFFFAOYSA-L	ILZDURAAGGSKOQ-WZHZPDAFSA-M
depudecin	DLVJMFOLJOOWFS-VCACHIOZSA-N	DLVJMFOLJOOWFS-LMSNBXBHSA-N	DLVJMFOLJOOWFS-VJIFSZOSSA-N
bergenin	YWJXCIXBAKGUKZ-HJJNZUOJSA-N
cefamandole	OLVCFLKTBJRLHI-AXAPSJFSSA-N
ouabain	LPMXVESGRSUGHW-HBYQJFLCSA-N
cromoglicic_acid	
etamsylate	HBGOLJKPSFNJSD-UHFFFAOYSA-N
domperidone	FGXWKSZFVQUSTL-UHFFFAOYSA-N
aciclovir	MKUXAQIIEYXACX-UHFFFAOYSA-N
budesonide	VOVIALXJUBGFJZ-KWVAZRHASA-N
fluorometholone	FAOZLTXFLGPHNG-KNAQIMQKSA-N
nordihydroguaiaretic_acid	
bacitracin	KCQUYQOMRRBRBJ-YPXIRHOPSA-N	CLKOFPXJLQSYAH-YBVXDRQKSA-N	CLKOFPXJLQSYAH-RNHDWVCBSA-N	CLKOFPXJLQSYAH-ABRJDSQDSA-N	UMERHSCYDIHODR-MUCBZBDISA-N	VRKHYMXTJQCIND-RNHDWVCBSA-N	CLKOFPXJLQSYAH-KWOGWQNJSA-N	VRKHYMXTJQCIND-UHFFFAOYSA-N	ADQCOQJMTUAWAR-XDEZYTCSSA-N	PWXDKDWMUFRAFQ-ULLMKCDFSA-N	USHOSLIEBCEAIY-UHFFFAOYSA-N	CLKOFPXJLQSYAH-UHFFFAOYSA-N	QSNOBVJFKSQBBD-UHFFFAOYSA-N	WKEIECNUXCQFAJ-OBZMNZJLSA-N	RHKCFWGPEDXSNT-IGRZHKPHSA-N
dexverapamil	SGTNSNPWRIOYBX-UHFFFAOYSA-N	SGTNSNPWRIOYBX-HHHXNRCGSA-N
alcuronium_chloride	
ampyrone	RLFWWDJHLFCNIJ-UHFFFAOYSA-N
Methiazole	SXJIZQPZESTWLD-UHFFFAOYSA-N
ioversol	AMDBBAQNWSUWGN-UHFFFAOYSA-N
desoxycortone	ZESRJSPZRDMNHY-YFWFAHHUSA-N
salbutamol	NDAUXUAQIAJITI-UHFFFAOYSA-N
chlorcyclizine	WFNAKBGANONZEQ-UHFFFAOYSA-N
amoxapine	QWGDMFLQWFTERH-UHFFFAOYSA-N
vinburnine	WYJAPUKIYAZSEM-MOPGFXCFSA-N
copper_sulfate	
ticlopidine	PHWBOXQYWZNQIN-UHFFFAOYSA-N
1,5-isoquinolinediol	LFUJIPVWTMGYDG-UHFFFAOYSA-N
5224221	
hydrocotarnine	XXANNZJIZQTCBP-UHFFFAOYSA-N
caffeic_acid	
TTNPB	FOIVPCKZDPCJJY-JQIJEIRASA-N
protriptyline	BWPIARFWQZKAIA-UHFFFAOYSA-N
benzethonium_chloride	
diloxanide	GZZZSOOGQLOEOB-UHFFFAOYSA-N
ethisterone	CHNXZKVNWQUJIB-CEGNMAFCSA-N
C-75	VCWLZDVWHQVAJU-UHFFFAOYSA-N
oxprenolol	CEMAWMOMDPGJMB-UHFFFAOYSA-N
pentetrazol	CWRVKFFCRWGWCS-UHFFFAOYSA-N
clobetasol	FCSHDIVRCWTZOX-DVTGEIKXSA-N
benfluorex	CJAVTWRYCDNHSM-UHFFFAOYSA-N
loxapine	XJGVXQDUIWGIRW-UHFFFAOYSA-N
disopyramide	UVTNFZQICZKOEM-UHFFFAOYSA-N
SB-202190	NJNKPVPFGLGHPA-UHFFFAOYSA-N
celastrol	KQJSQWZMSAGSHN-JJWQIEBTSA-N
glycocholic_acid	RFDAIACWWDREDC-FRVQLJSFSA-M
acenocoumarol	VABCILAOYCMVPS-UHFFFAOYSA-N
5286656	
nipecotic_acid	
BCB000038	
cytisine	ANJTVLIZGCUXLD-RKDXNWHRSA-N	ANJTVLIZGCUXLD-UHFFFAOYSA-N	ANJTVLIZGCUXLD-DTWKUNHWSA-N	ANJTVLIZGCUXLD-VEDVMXKPSA-N	ANJTVLIZGCUXLD-IUCAKERBSA-N
LM-1685	UBZBOEWMQPWUKB-UHFFFAOYSA-N
colistin	YKQOSKADJPQZHB-QNPLFGSASA-N
apomorphine	VMWNQDUVQKEIOC-CYBMUJFWSA-N
6-bromoindirubin-3'-oxime	WNWSUJQVZJJGLF-SQFISAMPSA-N
meclofenoxate	XZTYGFHCIAKPGJ-UHFFFAOYSA-N
valdecoxib	LNPDTQAFDNKSHK-UHFFFAOYSA-N
triprolidine	CBEQULMOCCWAQT-WOJGMQOQSA-N	CBEQULMOCCWAQT-WQRHYEAKSA-N
fursultiamine	JTLXCMOFVBXEKD-FOWTUZBSSA-N
naringenin	FTVWIRXFELQLPI-UHFFFAOYSA-N	FTVWIRXFELQLPI-ZDUSSCGKSA-N
pivmecillinam	NPGNOVNWUSPMDP-XZDBBAETSA-N	NPGNOVNWUSPMDP-HLLBOEOZSA-N
hexamethonium_bromide	
5109870	
apigenin	KZNIFHPLKGYRTM-UHFFFAOYSA-N
PHA-00745360	AKYSEDBFBNQOGJ-UHFFFAOYSA-N
amikacin	LKCWBDHBTVXHDL-RMDFUYIESA-N
terazosin	VCKUSRYTPJJLNI-UHFFFAOYSA-N
gossypol	QBKSWRVVCFFDOT-UHFFFAOYSA-N
viomycin	GXFAIFRPOKBQRV-GHXCTMGLSA-N	GXFAIFRPOKBQRV-GHXCTMGLSA-Q
trimethadione	IRYJRGCIQBGHIV-UHFFFAOYSA-N
tropine	CYHOMWAPJJPNMW-DHBOJHSNSA-N	CYHOMWAPJJPNMW-UHFFFAOYSA-N
Gly-His-Lys	MVORZMQFXBLMHM-QWRGUYRKSA-N
alexidine	LFVVNPBBFUSSHL-UHFFFAOYSA-N
trazodone	PHLBKPHSAVXXEF-UHFFFAOYSA-N
metitepine	RLJFTICUTYVZDG-UHFFFAOYSA-N
sulfamethizole	VACCAVUAMIDAGB-UHFFFAOYSA-N
santonin	XJHDMGJURBVLLE-BOCCBSBMSA-N	XJHDMGJURBVLLE-FDAGQKODSA-N	XJHDMGJURBVLLE-UABIXTSPSA-N	XJHDMGJURBVLLE-KWCXHHIESA-N	XJHDMGJURBVLLE-UHFFFAOYSA-N
dipyridamole	IZEKFCXSFNUWAM-UHFFFAOYSA-N
prilocaine	MVFGUOIZUNYYSO-UHFFFAOYSA-N
carbamazepine	FFGPTBGBLSHEPO-UHFFFAOYSA-N
(-)-catechin	PFTAWBLQPZVEMU-HIFRSBDPSA-N
dehydrocholic_acid	
dilazep	QVZCXCJXTMIDME-UHFFFAOYSA-N
sulfaphenazole	QWCJHSGMANYXCW-UHFFFAOYSA-N
pyrimethamine	WKSAUQYGYAYLPV-UHFFFAOYSA-N
methotrexate	FBOZXECLQNJBKD-ZDUSSCGKSA-N
4-hydroxyphenazone	
prednisolone	OIGNJSKKLXVSLS-VWUMJDOOSA-N
simvastatin	RYMZZMVNJRMUDD-HGQWONQESA-N
fipexide	BFUJHVVEMMWLHC-UHFFFAOYSA-N
S-propranolol	
hydralazine	RPTUSVTUFVMDQK-UHFFFAOYSA-N
iproniazid	NYMGNSNKLVNMIA-UHFFFAOYSA-N
iohexol	NTHXOOBQLCIOLC-UHFFFAOYSA-N
cefoxitin	WZOZEZRFJCJXNZ-ZBFHGGJFSA-N
sulfacetamide	SKIVFJLNDNKQPD-UHFFFAOYSA-N
trifluridine	VSQQQLOSPVPRAZ-RRKCRQDMSA-N
succinylsulfathiazole	SKVLYVHULOWXTD-UHFFFAOYSA-N
scopoletin	RODXRVNMMDRFIK-UHFFFAOYSA-N
flupentixol	NJMYODHXAKYRHW-BLLMUTORSA-N	NJMYODHXAKYRHW-DVZOWYKESA-N	NJMYODHXAKYRHW-UHFFFAOYSA-N
arachidonic_acid	YZXBAPSDXZZRGB-DOFZRALJSA-M
metixene	MJFJKKXQDNNUJF-UHFFFAOYSA-N
moxonidine	WPNJAUFVNXKLIM-UHFFFAOYSA-N
DL-PPMP	ORVAUBQYJOFWFY-ZHESDOBJSA-N
PF-01378883-00	OXDSQCMYJIEJHT-UHFFFAOYSA-N
CP-319743	RVAVTUCIVJJSQS-UHFFFAOYSA-N
SC-19220	KNURFLJTOUGOOQ-UHFFFAOYSA-N
tropicamide	BGDKAVGWHJFAGW-UHFFFAOYSA-N
erythromycin	ULGZDMOVFRHVEP-RWJQBGPGSA-N
IC-86621	YHKSBKQXCWHTQL-UHFFFAOYSA-N
0297417-0002B	
flecainide	DJBNUMBKLMJRSA-UHFFFAOYSA-N
florfenicol	AYIRNRDRBQJXIF-NXEZZACHSA-N
gliclazide	BOVGTQGAOIONJV-UHFFFAOYSA-N
BW-B70C	UAIYNMRLUHHRMF-AATRIKPKSA-N
wortmannin	QDLHCMPXEPAAMD-QAIWCSMKSA-N
demeclocycline	GUXHBMASAHGULD-UHFFFAOYSA-N	GUXHBMASAHGULD-SEYHBJAFSA-N
piribedil	OQDPVLVUJFGPGQ-UHFFFAOYSA-N
noretynodrel	ICTXHFFSOAJUMG-SLHNCBLASA-N
atractyloside	IUCNQFHEWLYECJ-CXCSZTQTSA-L	IUCNQFHEWLYECJ-NZWIRVDUSA-L	IUCNQFHEWLYECJ-UAPRPQGYSA-L	IUCNQFHEWLYECJ-FNAJZLPOSA-L
LY-294002	CZQHHVNHHHRRDU-UHFFFAOYSA-N
amitriptyline	KRMDCWKBEZIMAB-UHFFFAOYSA-N
BAS-012416453	
CP-320650-01	
benserazide	BNQDCRGUHNALGH-UHFFFAOYSA-N
karakoline	HKQZUYOVMYOFIT-VEUUHKJVSA-N	HKQZUYOVMYOFIT-ZSXQYPCHSA-N	HKQZUYOVMYOFIT-XIRBYKGTSA-N	HKQZUYOVMYOFIT-DAKPKMGASA-N	HKQZUYOVMYOFIT-UHFFFAOYSA-N	HKQZUYOVMYOFIT-FUHAYFRMSA-N	HKQZUYOVMYOFIT-VHNBHZRZSA-N	HKQZUYOVMYOFIT-NHNXFQBOSA-N
harman	PSFDQSOCUJVVGF-UHFFFAOYSA-N
roxithromycin	RXZBMPWDPOLZGW-RNLQMQBISA-N	RXZBMPWDPOLZGW-XMRMVWPWSA-N	RXZBMPWDPOLZGW-KMAKEOJNSA-N	RXZBMPWDPOLZGW-GWPRLELFSA-N	RXZBMPWDPOLZGW-UHFFFAOYSA-N	RXZBMPWDPOLZGW-HEWSMUCTSA-N	RXZBMPWDPOLZGW-FEMONOMJSA-N	RXZBMPWDPOLZGW-OUYQJUDISA-N	RXZBMPWDPOLZGW-AQMOSUNUSA-N	RXZBMPWDPOLZGW-HITVVWEBSA-N	RXZBMPWDPOLZGW-YVNHRGETSA-N
ketorolac	OZWKMVRBQXNZKK-UHFFFAOYSA-N
oxybenzone	DXGLGDHPHMLXJC-UHFFFAOYSA-N
cetirizine	ZKLPARSLTMPFCP-UHFFFAOYSA-N
heptaminol	LREQLEBVOXIEOM-UHFFFAOYSA-N
pindolol	JZQKKSLKJUAGIC-UHFFFAOYSA-N
glimepiride	WIGIZIANZCJQQY-UHFFFAOYSA-N
trichlormethiazide	LMJSLTNSBFUCMU-UHFFFAOYSA-N
splitomicin	ISFPDBUKMJDAJH-UHFFFAOYSA-N
tocainide	BUJAGSGYPOAWEI-UHFFFAOYSA-N
HNMPA-(AM)3	UQODAZKXEREJLZ-UHFFFAOYSA-N
ciprofibrate	KPSRODZRAIWAKH-UHFFFAOYSA-N
oxantel	VRYKTHBAWRESFI-VOTSOKGWSA-N
crotamiton	DNTGGZPQPQTDQF-XBXARRHUSA-N
trimethylcolchicinic_acid	
acetazolamide	BZKPWHYZMXOIDC-UHFFFAOYSA-N
nalidixic_acid	
cinoxacin	VDUWPHTZYNWKRN-UHFFFAOYSA-N
8-azaguanine	LPXQRXLUHJKZIE-UHFFFAOYSA-N
betamethasone	UREBDLICKHMUKA-DVTGEIKXSA-N
corynanthine	BLGXFZZNTVWLAY-DKJBZYCGSA-N
aminophenazone	RMMXTBMQSGEXHJ-UHFFFAOYSA-N
cefepime	HVFLCNVBZFFHBT-ZKDACBOMSA-N
5186223	
etofenamate	XILVEPYQJIOVNB-UHFFFAOYSA-N
bambuterol	ANZXOIAKUNOVQU-UHFFFAOYSA-N
phenelzine	RMUCZJUITONUFY-UHFFFAOYSA-N
MG-262	MWKOOGAFELWOCD-FKBYEOEOSA-N	GPWIPTHHAKFKLH-FKBYEOEOSA-N
STOCK1N-35696	PXNLMHCHVRNEPI-UHFFFAOYSA-N
hesperidin	QUQPHWDTPGMPEX-UZRWAPQLSA-N	QUQPHWDTPGMPEX-UHFFFAOYSA-N	QUQPHWDTPGMPEX-RBSJMJCGSA-N	QUQPHWDTPGMPEX-PZKWUUPXSA-N	QUQPHWDTPGMPEX-SGHBVPQBSA-N	QUQPHWDTPGMPEX-QJBIFVCTSA-N	QUQPHWDTPGMPEX-UNZJSITISA-N	QUQPHWDTPGMPEX-DPTDPGGASA-N
oxetacaine	FTLDJPRFCGDUFH-UHFFFAOYSA-N
tolfenamic_acid	
miconazole	BYBLEWFAAKGYCD-UHFFFAOYSA-N
napelline	AZAZKLKDEOMJBJ-BOPAMEKVSA-N	AZAZKLKDEOMJBJ-XNCGQIBVSA-N	AZAZKLKDEOMJBJ-OLOAVZRQSA-N	AZAZKLKDEOMJBJ-KSCSQDNTSA-N
vinblastine	JXLYSJRDGCGARV-XQKSVPLYSA-N	JXLYSJRDGCGARV-CUGARIAGSA-N	JXLYSJRDGCGARV-CFWMRBGOSA-N	JXLYSJRDGCGARV-UHFFFAOYSA-N	JXLYSJRDGCGARV-JQQWJEIDSA-N
tenoxicam	LZNWYQJJBLGYLT-UHFFFAOYSA-N
meptazinol	JLICHNCFTLFZJN-UHFFFAOYSA-N
cefalexin	ZAIPMKNFIOOWCQ-UEKVPHQBSA-N
phenindione	NFBAXHOPROOJAW-UHFFFAOYSA-N
zardaverine	HJMQDJPMQIHLPB-UHFFFAOYSA-N
sulfinpyrazone	MBGGBVCUIVRRBF-UHFFFAOYSA-N
MG-132	TZYWCYJVHRLUCT-VABKMULXSA-N
trimipramine	ZSCDBOWYZJWBIY-UHFFFAOYSA-N
isoconazole	MPIPASJGOJYODL-UHFFFAOYSA-N
dextromethorphan	MKXZASYAUGDDCJ-KBAYOESNSA-N	MKXZASYAUGDDCJ-CGTJXYLNSA-N	MKXZASYAUGDDCJ-NJAFHUGGSA-N	MKXZASYAUGDDCJ-JQHSSLGASA-N	MKXZASYAUGDDCJ-UHFFFAOYSA-N
benzylpenicillin	JGSARLDLIJGVTE-MBNYWOFBSA-N
doxorubicin	AOJJSUZBOXZQNB-TZSSRYMLSA-N
deptropine	ZWPODSUQWXAZNC-YOFSQIOKSA-N	ZWPODSUQWXAZNC-UHFFFAOYSA-N
gabexate	YKGYIDJEEQRWQH-UHFFFAOYSA-N
trioxysalen	FMHHVULEAZTJMA-UHFFFAOYSA-N
imipramine	BCGWQEUPMDMJNV-UHFFFAOYSA-N
bretylium_tosilate	
eticlopride	AADCDMQTJNYOSS-LBPRGKRZSA-N
lorglumide	IEKOTSCYBBDIJC-UHFFFAOYSA-N
ciclosporin	PMATZTZNYRCHOR-IMVLJIQESA-N	PMATZTZNYRCHOR-VJRYSDSKSA-N	PMATZTZNYRCHOR-KMSBSJHKSA-N	PMATZTZNYRCHOR-UHFFFAOYSA-N	PMATZTZNYRCHOR-CGLBZJNRSA-N	PMATZTZNYRCHOR-QVSDIVLPSA-N
sulindac_sulfide	
SR-95531	GFZHNFOGCMEYTA-UHFFFAOYSA-N
zaprinast	REZGGXNDEMKIQB-UHFFFAOYSA-N
oxyphenbutazone	HFHZKZSRXITVMK-UHFFFAOYSA-N
carteolol	LWAFSWPYPHEXKX-UHFFFAOYSA-N
colchicine	IAKHMKGGTNLKSZ-INIZCTEOSA-N
sulfametoxydiazine	GPTONYMQFTZPKC-UHFFFAOYSA-N
PHA-00767505E	
tracazolate	PCTRYMLLRKWXGF-UHFFFAOYSA-N
SC-58125	JHBIMJKLBUMNAU-UHFFFAOYSA-N
sparteine	SLRCCWJSBJZJBV-NMWPEEMBSA-N	SLRCCWJSBJZJBV-UHFFFAOYSA-N	SLRCCWJSBJZJBV-ZQDZILKHSA-N	SLRCCWJSBJZJBV-AJNGGQMLSA-N	SLRCCWJSBJZJBV-TUVASFSCSA-N
flurbiprofen	SYTBZMRGLBWNTM-UHFFFAOYSA-N
theobromine	YAPQBXQYLJRXSA-UHFFFAOYSA-N
pheneticillin	NONJJLVGHLVQQM-JHXYUMNGSA-N
hemicholinium	JIWUESGGKYLPPG-UHFFFAOYSA-N
cefixime	OKBVVJOGVLARMR-VINNURBNSA-N	OKBVVJOGVLARMR-UHFFFAOYSA-N	OKBVVJOGVLARMR-QSWIMTSFSA-N	OKBVVJOGVLARMR-AWQFTUOYSA-N	OKBVVJOGVLARMR-QMTHXVAHSA-N
velnacrine	HLVVITIHAZBPKB-UHFFFAOYSA-N
carbarsone	WWXBHTZSYYGCSG-UHFFFAOYSA-N
midodrine	PTKSEFOSCHHMPD-UHFFFAOYSA-N
epirizole	RHAXSHUQNIEUEY-UHFFFAOYSA-N
papaverine	XQYZDYMELSJDRZ-UHFFFAOYSA-N
carmustine	DLGOEMSEDOSKAD-UHFFFAOYSA-N
ikarugamycin	GHXZHWYUSAWISC-BFVJYCBLSA-N	GHXZHWYUSAWISC-UHFFFAOYSA-N
tioguanine	WYWHKKSPHMUBEB-UHFFFAOYSA-N
chlorzoxazone	TZFWDZFKRBELIQ-UHFFFAOYSA-N
benperidol	FEBOTPHFXYHVPL-UHFFFAOYSA-N
clemastine	YNNUSGIPVFPVBX-NHCUHLMSSA-N
naftifine	OZGNYLLQHRPOBR-DHZHZOJOSA-N
tacrine	YLJREFDVOIBQDA-UHFFFAOYSA-N
hydrastine_hydrochloride	
asiaticoside	WYQVAPGDARQUBT-UHFFFAOYSA-N	WYQVAPGDARQUBT-JVGKFWCXSA-N	WYQVAPGDARQUBT-HJCNVAKJSA-N	WYQVAPGDARQUBT-NNUNPJGWSA-N	WYQVAPGDARQUBT-FGWHUCSPSA-N	WYQVAPGDARQUBT-LTLCQFKNSA-N	WYQVAPGDARQUBT-TZXSXNIFSA-N
ceftazidime	ORFOPKXBNMVMKC-DWVKKRMSSA-N
dihydroergotamine	LUZRJRNZXALNLM-JGRZULCMSA-N
5211181	
troglitazone	GXPHKUHSUJUWKP-UHFFFAOYSA-N
meprylcaine	VXJABHHJLXLNMP-UHFFFAOYSA-N
ramifenazone	XOZLRRYPUKAKMU-UHFFFAOYSA-N
spiperone	DKGZKTPJOSAWFA-UHFFFAOYSA-N
5255229	
hydroflumethiazide	DMDGGSIALPNSEE-UHFFFAOYSA-N
2,6-dimethylpiperidine	SDGKUVSVPIIUCF-UHFFFAOYSA-N
ketanserin	FPCCSQOGAWCVBH-UHFFFAOYSA-N
mefexamide	HUNIPYLVUPMFCZ-UHFFFAOYSA-N	AXBHPHPHZHAOAK-UHFFFAOYSA-N
cefazolin	MLYYVTUWGNIJIB-BXKDBHETSA-N
ethambutol	AEUTYOVWOVBAKS-NXEZZACHSA-N	AEUTYOVWOVBAKS-UWVGGRQHSA-N	AEUTYOVWOVBAKS-UHFFFAOYSA-N
lasalocid	BBMULGJBVDDDNI-OWKLGTHSSA-N
Condelphine 	ZEBMMHUDQRRILP-WZSMAATHSA-N	ZEBMMHUDQRRILP-SRMUXAQSSA-N	ZEBMMHUDQRRILP-UHFFFAOYSA-N	ZEBMMHUDQRRILP-YGMHWARESA-N	ZEBMMHUDQRRILP-WURUDWSYSA-N
hesperetin	AIONOLUJZLIMTK-AWEZNQCLSA-N
etiocholanolone	QGXBDMJGAMFCBF-BNSUEQOYSA-N
digoxigenin	SHIBSTMRCDJXLN-KCZCNTNESA-N
clozapine	ZUXABONWMNSFBN-UHFFFAOYSA-N
diflunisal	HUPFGZXOMWLGNK-UHFFFAOYSA-N
procainamide	REQCZEXYDRLIBE-UHFFFAOYSA-N
debrisoquine	JWPGJSVJDAJRLW-UHFFFAOYSA-N
antimycin_A	
paromomycin	UOZODPSAJZTQNH-LSWIJEOBSA-N
parthenolide	KTEXNACQROZXEV-PWNZVWSESA-N	KTEXNACQROZXEV-UHFFFAOYSA-N	KTEXNACQROZXEV-ZRPLFPEYSA-N	KTEXNACQROZXEV-QLIGOWBFSA-N	KTEXNACQROZXEV-SLXBATTESA-N	KTEXNACQROZXEV-UITAMQMPSA-N	KTEXNACQROZXEV-PVLRGYAZSA-N	KTEXNACQROZXEV-CDQRVUJFSA-N	KTEXNACQROZXEV-RMRHIDDWSA-N	KTEXNACQROZXEV-HMULZPFASA-N	KTEXNACQROZXEV-WEVVVXLNSA-N
imipenem	ZSKVGTPCRGIANV-ZXFLCMHBSA-N
paroxetine	AHOUBRCZNHFOSL-YOEHRIQHSA-N
AH-6809	AQFFXPQJLZFABJ-UHFFFAOYSA-N
norcyclobenzaprine	XECQQDXTQRYYBH-UHFFFAOYSA-N
acetohexamide	VGZSUPCWNCWDAN-UHFFFAOYSA-N
oxamic_acid	
fenbendazole	HDDSHPAODJUKPD-UHFFFAOYSA-N
menadione	MJVAVZPDRWSRRC-UHFFFAOYSA-N
iopanoic_acid	
sulfaguanidine	BRBKOPJOKNSWSG-UHFFFAOYSA-N
phenyl_biguanide	
betazole	JXDFEQONERDKSS-UHFFFAOYSA-N
NS-398	KTDZCOWXCWUPEO-UHFFFAOYSA-N
seneciphylline	FCEVNJIUIMLVML-QPSVUOIXSA-N
terfenadine	GUGOEEXESWIERI-UHFFFAOYSA-N
thioperamide	QKDDJDBFONZGBW-UHFFFAOYSA-N
suloctidil	BFCDFTHTSVTWOG-UHFFFAOYSA-N
finasteride	DBEPLOCGEIEOCV-WSBQPABSSA-N
etidronic_acid	
metaraminol	WXFIGDLSSYIKKV-RCOVLWMOSA-N
alfadolone	XWYBFXIUISNTQG-VKMGZQQJSA-N
sulindac	MLKXDPUZXIRXEP-MFOYZWKCSA-N
6-Hydroxytropinone 	UOHSTKWPZWFYTF-UHFFFAOYSA-N
proxymetacaine	KCLANYCVBBTKTO-UHFFFAOYSA-N
benfotiamine	BTNNPSLJPBRMLZ-GHRIWEEISA-N	BTNNPSLJPBRMLZ-LGMDPLHJSA-N	BTNNPSLJPBRMLZ-UHFFFAOYSA-N
atovaquone	BSJMWHQBCZFXBR-UHFFFAOYSA-N
telenzepine	VSWPGAIWKHPTKX-UHFFFAOYSA-N
dorzolamide	IAVUPMFITXYVAF-XPUUQOCRSA-N
xamoterol	DXPOSRCHIDYWHW-UHFFFAOYSA-N
nialamide	NOIIUHRQUVNIDD-UHFFFAOYSA-N
astemizole	GXDALQBWZGODGZ-UHFFFAOYSA-N
levocabastine	ZCGOMHNNNFPNMX-YHYDXASRSA-N
dequalinium_chloride	
megestrol	VXIMPSPISRVBPZ-NWUMPJBXSA-N
acacetin	DANYIYRPLHHOCZ-UHFFFAOYSA-N
rottlerin	DEZFNHCVIZBHBI-ZHACJKMWSA-N
skimmianine	SLSIBLKBHNKZTB-UHFFFAOYSA-N
hycanthone	MFZWMTSUNYWVBU-UHFFFAOYSA-N
etofylline	NWPRCRWQMGIBOT-UHFFFAOYSA-N
ursodeoxycholic_acid	
sulfasalazine	OQANPHBRHBJGNZ-BKUYFWCQSA-N	OQANPHBRHBJGNZ-UHFFFAOYSA-N	OQANPHBRHBJGNZ-FYJGNVAPSA-N
aztreonam	WZPBZJONDBGPKJ-VEHQQRBSSA-L	WZPBZJONDBGPKJ-VEHQQRBSSA-N	WZPBZJONDBGPKJ-VEHQQRBSSA-N
terguride	JOAHPSVPXZTVEP-YXJHDRRASA-N
SB-203580	CDMGBJANTYXAIV-UHFFFAOYSA-N
cicloheximide	YPHMISFOHDHNIV-FSZOTQKASA-N
thiocolchicoside	LEQAKWQJCITZNK-MPVWKRLLSA-N	LEQAKWQJCITZNK-AXHKHJLKSA-N	LEQAKWQJCITZNK-MSQQGMGVSA-N	LEQAKWQJCITZNK-UHFFFAOYSA-N
nizatidine	SGXXNSQHWDMGGP-IZZDOVSWSA-N
tomatidine	XYNPYHXGMWJBLV-VXPJTDKGSA-N	XYNPYHXGMWJBLV-IAQRSOHTSA-N	XYNPYHXGMWJBLV-UHFFFAOYSA-N	XYNPYHXGMWJBLV-PODJHBEMSA-N	XYNPYHXGMWJBLV-NYAPYGRYSA-N	XYNPYHXGMWJBLV-PUHUBZITSA-N
melatonin	DRLFMBDRBRZALE-UHFFFAOYSA-N
fusaric_acid	
meropenem	DMJNNHOOLUXYBV-PQTSNVLCSA-N
bisacodyl	KHOITXIGCFIULA-UHFFFAOYSA-N
sulfamethoxypyridazine	VLYWMPOKSSWJAL-UHFFFAOYSA-N
minaprine	LDMWSLGGVTVJPG-UHFFFAOYSA-N
allantoin	POJWUDADGALRAB-UHFFFAOYSA-N
retrorsine	BCJMNZRQJAVDLD-UHFFFAOYSA-N	BCJMNZRQJAVDLD-BASWHVEKSA-N	BCJMNZRQJAVDLD-CQRYIUNCSA-N	BCJMNZRQJAVDLD-XRVQXMHSSA-N	BCJMNZRQJAVDLD-FXGRWVCYSA-N	BCJMNZRQJAVDLD-OQIMHWJESA-N	BCJMNZRQJAVDLD-XKLVTHTNSA-N
doxazosin	RUZYUOTYCVRMRZ-UHFFFAOYSA-N
lycorine	XGVJWXAYKUHDOO-DANNLKNASA-N
paracetamol	RZVAJINKPMORJF-UHFFFAOYSA-N
azaperone	XTKDAFGWCDAMPY-UHFFFAOYSA-N
alverine	ZPFXAOWNKLFJDN-UHFFFAOYSA-N
terbutaline	XWTYSIMOBUGWOL-UHFFFAOYSA-N
dacarbazine	OMJKFYKNWZZKTK-UHFFFAOYSA-N	OMJKFYKNWZZKTK-UXBLZVDNSA-N	OMJKFYKNWZZKTK-POHAHGRESA-N
decitabine	XAUDJQYHKZQPEU-KVQBGUIXSA-N
PNU-0293363	GREINGGQNRFZML-UHFFFAOYSA-N
podophyllotoxin	YJGVMLPVUAXIQN-XVVDYKMHSA-N
ebselen	DYEFUKCXAQOFHX-UHFFFAOYSA-N
etanidazole	WCDWBPCFGJXFJZ-UHFFFAOYSA-N
praziquantel	FSVJFNAIGNNGKK-UHFFFAOYSA-N
lobeline	MXYUKLILVYORSK-HBMCJLEFSA-N	MXYUKLILVYORSK-QHAWAJNXSA-N	MXYUKLILVYORSK-UHFFFAOYSA-N	MXYUKLILVYORSK-PWRODBHTSA-N	MXYUKLILVYORSK-HKBOAZHASA-N
semustine	FVLVBPDQNARYJU-UHFFFAOYSA-N
monastrol	LOBCDGHHHHGHFA-UHFFFAOYSA-N
thiostrepton	NSFFHOGKXHRQEW-YTTXGCAFSA-N	NSFFHOGKXHRQEW-DVRIZHICSA-N	NSFFHOGKXHRQEW-BXVAPQLOSA-N	NSFFHOGKXHRQEW-GLAXDNAISA-N	NSFFHOGKXHRQEW-LBLKBEOSSA-N	NSFFHOGKXHRQEW-AIHSUZKVSA-N	NSFFHOGKXHRQEW-UHFFFAOYSA-N	NSFFHOGKXHRQEW-IYJGLQIGSA-N	NSFFHOGKXHRQEW-SKAGQBDNSA-N	NSFFHOGKXHRQEW-UCWLGDPNSA-N	NSFFHOGKXHRQEW-BEEVBQKTSA-N
protoveratrine_A	
6-azathymine	XZWMZFQOHTWGQE-UHFFFAOYSA-N
cloperastine	FLNXBVJLPJNOSI-UHFFFAOYSA-N
puromycin	RXWNCPJZOCPEPQ-ZRKVXJNMSA-N	RXWNCPJZOCPEPQ-UHFFFAOYSA-N	RXWNCPJZOCPEPQ-NVWDDTSBSA-N	RXWNCPJZOCPEPQ-FNQTVZJVSA-N
lactobionic_acid	
betulinic_acid	
resveratrol	LUKBXSAWLPMMSZ-OWOJBTEDSA-N
dyclonine	BZEWSEKUUPWQDQ-UHFFFAOYSA-N
profenamine	CDOZDBSBBXSXLB-UHFFFAOYSA-N
khellin	HSMPDPBYAYSOBC-UHFFFAOYSA-N
gefitinib	XGALLCVXEZPNRQ-UHFFFAOYSA-N
clotrimazole	VNFPBHJOKIVQEB-UHFFFAOYSA-N
cefotaxime	GPRBEKHLDVQUJE-CPAGPLPBSA-N	GPRBEKHLDVQUJE-UKWGHVSLSA-N	GPRBEKHLDVQUJE-QSWIMTSFSA-N	GPRBEKHLDVQUJE-VINNURBNSA-N	GPRBEKHLDVQUJE-QMTHXVAHSA-N
PNU-0251126	YZACKGVHBXSSRN-UHFFFAOYSA-N
ascorbic_acid	
talampicillin	SOROUYSPFADXSN-SUWVAFIASA-N
THIP Hydrochloride	ZDZDSZQYRBZPNN-UHFFFAOYSA-N
loperamide	RDOIQAHITMMDAJ-UHFFFAOYSA-N
phenazone	VEQOALNAAJBPNY-UHFFFAOYSA-N
clindamycin	KDLRVYVGXIQJDK-LTKXHINDSA-N	KDLRVYVGXIQJDK-NOWPCOIGSA-N	KDLRVYVGXIQJDK-PSUNAQLJSA-N	KDLRVYVGXIQJDK-BWDNZIMNSA-N	KDLRVYVGXIQJDK-ZUWRKQLMSA-N	KDLRVYVGXIQJDK-UHFFFAOYSA-N	KDLRVYVGXIQJDK-GOBYPPTJSA-N	KDLRVYVGXIQJDK-AWPVFWJPSA-N
tribenoside	ULLNJSBQMBKOJH-VIVFLBMVSA-N	ULLNJSBQMBKOJH-NUZMXOBKSA-N	ULLNJSBQMBKOJH-AUZHQEEXSA-N	ULLNJSBQMBKOJH-SCNPRXQJSA-N
risperidone	RAPZEAPATHNIPO-UHFFFAOYSA-N
ketoconazole	XMAYWYJOQHXEEK-UHFFFAOYSA-N	XMAYWYJOQHXEEK-OZXSUGGESA-N	XMAYWYJOQHXEEK-NASUQTAISA-N	XMAYWYJOQHXEEK-ZEQKJWHPSA-N
sanguinarine	INVGWHRKADIJHF-UHFFFAOYSA-N
Reserpinic acid hydrochloride	QLKKMNXYROCXRE-BCRILHLVSA-N
flunisolide	XSFJVAJPIHIPKU-XWCQMRHXSA-N
iocetamic_acid	
2-deoxy-D-glucose	PMMURAAUARKVCB-CERMHHMHSA-N	PMMURAAUARKVCB-DQBDMIDPSA-N	PMMURAAUARKVCB-IHKGAJJJSA-N	PMMURAAUARKVCB-UHFFFAOYSA-N	PMMURAAUARKVCB-BXKVDMCESA-N	PMMURAAUARKVCB-ZXXMMSQZSA-N
PF-00562151-00	LYZSEMRUCHMGHT-UHFFFAOYSA-N
meclofenamic_acid	
fendiline	NMKSAYKQLCHXDK-UHFFFAOYSA-N
ganciclovir	IRSCQMHQWWYFCW-UHFFFAOYSA-N
flucloxacillin	UIOFUWFRIANQPC-JKIFEVAISA-N
primidone	DQMZLTXERSFNPB-UHFFFAOYSA-N
mefenamic_acid	
canrenoic_acid	
dexibuprofen	HEFNNWSXXWATRW-JTQLQIEISA-N
chlorprothixene	WSPOMRSOLSGNFJ-VGOFMYFVSA-N	WSPOMRSOLSGNFJ-UHFFFAOYSA-N	WSPOMRSOLSGNFJ-AUWJEWJLSA-N
fenspiride	FVNFBBAOMBJTST-UHFFFAOYSA-N
aminocaproic_acid	
pimethixene	NZLVRVYNQYGMAB-UHFFFAOYSA-N
doxylamine	HCFDWZZGGLSKEP-UHFFFAOYSA-N
clofibrate	KNHUKKLJHYUCFP-UHFFFAOYSA-N
cimetidine	AQIXAKUUQRKLND-UHFFFAOYSA-N
suprofen	MDKGKXOCJGEUJW-UHFFFAOYSA-N
chlorogenic_acid	
iodixanol	NBQNWMBBSKPBAY-UHFFFAOYSA-N
indoprofen	RJMIEHBSYVWVIN-UHFFFAOYSA-N
folic_acid	
ionomycin	PGHMRUGBZOYCAA-UHFFFAOYSA-N	PGHMRUGBZOYCAA-LUEAQUJLSA-N	PGHMRUGBZOYCAA-ADZNBVRBSA-N	PGHMRUGBZOYCAA-OJFQOPKISA-N	PGHMRUGBZOYCAA-XTWVDNPKSA-N
eucatropine	QSAVEGSLJISCDF-UHFFFAOYSA-N
ricinine	PETSAYFQSGAEQY-UHFFFAOYSA-N
Methylhydantoin-5-(D) 	VMAQYKGITHDWKL-UWTATZPHSA-N
dipivefrine	OCUJLLGVOUDECM-UHFFFAOYSA-N
3-hydroxy-DL-kynurenine	VCKPUUFAIGNJHC-UHFFFAOYSA-N
MK-886	QAOAOVKBIIKRNL-UHFFFAOYSA-M	CBNCIYNCWVGEKJ-UHFFFAOYSA-M	QAOAOVKBIIKRNL-UHFFFAOYSA-N
anisomycin	YKJYKKNCCRKFSL-RDBSUJKOSA-N
cinchonine	KMPWYEUPVWOPIM-QHQSXHFQSA-N	KMPWYEUPVWOPIM-FGVBSWQGSA-N	KMPWYEUPVWOPIM-LSOMNZGLSA-N	KMPWYEUPVWOPIM-YXUGBTPSSA-N	KMPWYEUPVWOPIM-TUFGIGEDSA-N	KMPWYEUPVWOPIM-UHFFFAOYSA-N	KMPWYEUPVWOPIM-ROKHWCPASA-N	KMPWYEUPVWOPIM-QAMTZSDWSA-N	KMPWYEUPVWOPIM-CFGMGRTJSA-N	KMPWYEUPVWOPIM-ZDUAUTNDSA-N	KMPWYEUPVWOPIM-AZZCIJICSA-N
sulfamethoxazole	JLKIGFTWXXRPMT-UHFFFAOYSA-N
Ungerine nitrate	PSCZYIVKEHPWIP-VYRMFUMRSA-N	PSCZYIVKEHPWIP-KGUHFNSXSA-N
cefuroxime	JFPVXVDWJQMJEE-UHFFFAOYSA-N	JFPVXVDWJQMJEE-SWWZKJRFSA-N	JFPVXVDWJQMJEE-QMTHXVAHSA-N	JFPVXVDWJQMJEE-NCEVBZPASA-N	JFPVXVDWJQMJEE-IZRZKJBUSA-N
pheniramine	IJHNSHDBIRRJRN-UHFFFAOYSA-N
idoxuridine	XQFRJNBWHJMXHO-RRKCRQDMSA-N
indometacin	CGIGDMFJXJATDK-UHFFFAOYSA-N
rolipram	HJORMJIFDVBMOB-UHFFFAOYSA-N
pararosaniline	AFAIELJLZYUNPW-UHFFFAOYSA-N	JUQPZRLQQYSMEQ-UHFFFAOYSA-N	JUQPZRLQQYSMEQ-UHFFFAOYSA-N
tyrphostin_AG-825	
alfaxalone	DUHUCHOQIDJXAT-OLVMNOGESA-N
nimesulide	HYWYRSMBCFDLJT-UHFFFAOYSA-N
lobelanidine	OWGJQNXIWMMDTH-UHFFFAOYSA-N
moxisylyte	VRYMTAVOXVTQEF-UHFFFAOYSA-N
pyrazinamide	IPEHBUMCGVEMRF-UHFFFAOYSA-N
(+) -Levobunolol hydrochloride 	DNTDOBSIBZKFCP-UTONKHPSSA-N
felodipine	RZTAMFZIAATZDJ-UHFFFAOYSA-N
ginkgolide_A	
PHA-00846566E	DQPBKZBZDUDPSL-UHFFFAOYSA-N
lysergol	BIXJFIJYBLJTMK-MEBBXXQBSA-N
moracizine	FUBVWMNBEHXPSU-UHFFFAOYSA-N
vidarabine	OIRDTQYFTABQOQ-KBNQYOMWSA-N	OIRDTQYFTABQOQ-UHFFFAOYSA-N	OIRDTQYFTABQOQ-JZUOCJJVSA-N	OIRDTQYFTABQOQ-PKJMTWSGSA-N	OIRDTQYFTABQOQ-KQYNXXCUSA-N	OIRDTQYFTABQOQ-UHTZMRCNSA-N
5152487	
yohimbine	BLGXFZZNTVWLAY-SCYLSFHTSA-N
methocarbamol	GNXFOGHNGIVQEH-UHFFFAOYSA-N
5253409	
alsterpaullone	OLUKILHGKRVDCT-UHFFFAOYSA-N
hydroquinine	LJOQGZACKSYWCH-WGFDLZGGSA-N	LJOQGZACKSYWCH-LHHVKLHASA-N	LJOQGZACKSYWCH-DMHQBCLBSA-N	LJOQGZACKSYWCH-WZBLMQSHSA-N	LJOQGZACKSYWCH-VOMFEXJBSA-N	LJOQGZACKSYWCH-AFHBHXEDSA-N	LJOQGZACKSYWCH-UHFFFAOYSA-N
lanatoside_C	
ifenprodil	UYNVMODNBIQBMV-UHFFFAOYSA-N
epitiostanol	OBMLHUPNRURLOK-SRHOXBKMSA-N	OBMLHUPNRURLOK-XGRAFVIBSA-N	OBMLHUPNRURLOK-XZIWUYRLSA-N	OBMLHUPNRURLOK-UHFFFAOYSA-N
bufexamac	MXJWRABVEGLYDG-UHFFFAOYSA-N
eldeline	DTTPWCNKTMQMTE-UHFFFAOYSA-N	DTTPWCNKTMQMTE-OJQGQUOWSA-N	DTTPWCNKTMQMTE-DZZCPBQSSA-N
dropropizine	PTVWPYVOOKLBCG-UHFFFAOYSA-N
letrozole	HPJKCIUCZWXJDR-UHFFFAOYSA-N
nefopam	RGPDEAGGEXEMMM-UHFFFAOYSA-N
canavanine	FSBIGDSBMBYOPN-UHFFFAOYSA-N	FSBIGDSBMBYOPN-VKHMYHEASA-N
prasterone	FMGSKLZLMKYGDP-UHFFFAOYSA-N	FMGSKLZLMKYGDP-INNQQZFDSA-N	FMGSKLZLMKYGDP-SNHNPKPASA-N	FMGSKLZLMKYGDP-IHFGAHDLSA-N	FMGSKLZLMKYGDP-USOAJAOKSA-N
chloramphenicol	WIIZWVCIJKGZOK-RKDXNWHRSA-N
pimozide	YVUQSNJEYSNKRX-UHFFFAOYSA-N
mephenesin	JWDYCNIAQWPBHD-UHFFFAOYSA-N
propantheline_bromide	
lomefloxacin	ZEKZLJVOYLTDKK-UHFFFAOYSA-N
clofilium_tosylate	
triflupromazine	XSCGXQMFQXDFCW-UHFFFAOYSA-N
tolbutamide	JLRGJRBPOGGCBT-UHFFFAOYSA-N
etacrynic_acid	
parbendazole	YRWLZFXJFBZBEY-UHFFFAOYSA-N
L-methionine_sulfoximine	
(-)-Eseroline fumarate salt 	PBZRRADJWNBPNY-FRSRHQBUSA-N	PBZRRADJWNBPNY-XDRMOJKASA-N
ritodrine	IOVGROKTTNBUGK-SJCJKPOMSA-N
SC-560	PQUGCKBLVKJMNT-UHFFFAOYSA-N
rifabutin	ATEBXHFBFRCZMA-VXTBVIBXSA-N
pramocaine	DQKXQSGTHWVTAD-UHFFFAOYSA-N
streptomycin	UCSJYZPVAKXKNQ-LPZYXKHESA-N	UCSJYZPVAKXKNQ-UJGCCNJDSA-N	UCSJYZPVAKXKNQ-PMUJNECLSA-N	UCSJYZPVAKXKNQ-ZCTIVXDHSA-N	UCSJYZPVAKXKNQ-HZYVHMACSA-N	UCSJYZPVAKXKNQ-UHFFFAOYSA-N	UCSJYZPVAKXKNQ-APUVXCOVSA-N
verteporfin	NJLRKAMQPVVOIU-CJJICDMVSA-N	NJLRKAMQPVVOIU-IDLGWYNRSA-N	YTZALCGQUPRCGW-ZSFNYQMMSA-N	ZQFGRJWRSLZCSQ-ZSFNYQMMSA-N	CABKTHJNHVBKCC-ZSFNYQMMSA-N	NJLRKAMQPVVOIU-UHFFFAOYSA-N	YTZALCGQUPRCGW-UMBAWLCISA-N
estriol	PROQIPRRNZUXQM-ZXXIGWHRSA-N
nalbuphine	NETZHAKZCGBWSS-CEDHKZHLSA-N
solanine	ZGVSETXHNHBTRK-NPQOSWHTSA-N	ZGVSETXHNHBTRK-UDJLNJFBSA-N	ZGVSETXHNHBTRK-OTYSSXIJSA-N	ZGVSETXHNHBTRK-UHFFFAOYSA-N	ZGVSETXHNHBTRK-WWELWOLRSA-N
thiamine	JZRWCGZRTZMZEH-UHFFFAOYSA-N
5213008	
camptothecin	VSJKWCGYPAHWDS-FQEVSTJZSA-N
Dimaprit dihydrochloride 	DFWCPLGXFMSUCW-UHFFFAOYSA-N
altizide	VGLGVJVUHYTIIU-UHFFFAOYSA-N
spiradoline	NYKCGQQJNVPOLU-ONTIZHBOSA-N
piperidolate	KTHVBAZBLKXIHZ-UHFFFAOYSA-N
5707885	
levothyroxine_sodium	
phentolamine	MRBDMNSDAVCSSF-UHFFFAOYSA-N
quinisocaine	XNMYNYSCEJBRPZ-UHFFFAOYSA-N
tolnaftate	FUSNMLFNXJSCDI-UHFFFAOYSA-N
amrinone	RNLQIBCLLYYYFJ-UHFFFAOYSA-N
naloxone	UZHSEJADLWPNLE-GRGSLBFTSA-N
octopamine	QHGUCRYDKWKLMG-UHFFFAOYSA-N
PF-00875133-00	
clopamide	LBXHRAWDUMTPSE-UHFFFAOYSA-N
phenazopyridine	QPFYXYFORQJZEC-UHFFFAOYSA-N
promazine	ZGUGWUXLJSTTMA-UHFFFAOYSA-N
heliotrine	LMFKRLGHEKVMNT-UJDVCPFMSA-N	LMFKRLGHEKVMNT-UYHMYPTGSA-N	LMFKRLGHEKVMNT-UHFFFAOYSA-N	LMFKRLGHEKVMNT-SLTLEMIRSA-N
5151277	
tomelukast	MWYHLEQJTQJHSS-UHFFFAOYSA-N
esculetin	ILEDWLMCKZNDJK-UHFFFAOYSA-N
nocodazole	KYRVNWMVYQXFEU-UHFFFAOYSA-N
dihydrostreptomycin	ASXBYYWOLISCLQ-HZYVHMACSA-N	ASXBYYWOLISCLQ-PMUJNECLSA-N	ASXBYYWOLISCLQ-GBHVFDGSSA-N	ASXBYYWOLISCLQ-HUOHZKRVSA-N
alfuzosin	WNMJYKCGWZFFKR-UHFFFAOYSA-N
torasemide	NGBFQHCMQULJNZ-UHFFFAOYSA-N
STOCK1N-28457	ODLCWRPXBNVZCY-UHFFFAOYSA-N
adrenosterone	RZRPTBIGEANTGU-IRIMSJTPSA-N
tridihexethyl	NPRHVSBSZMAEIN-UHFFFAOYSA-N
pinacidil	IVVNZDGDKPTYHK-UHFFFAOYSA-N
dienestrol	NFDFQCUYFHCNBW-SCGPFSFSSA-N
methanthelinium_bromide	
anabasine	MTXSIJUGVMTTMU-UHFFFAOYSA-N
testosterone	MUMGGOZAMZWBJJ-DYKIIFRCSA-N
piromidic_acid	
Delcorine	XTLROSDJDZHIIK-YXSVQGFMSA-N	XTLROSDJDZHIIK-JXBMVEQUSA-N	XTLROSDJDZHIIK-VIGIWSGCSA-N	XTLROSDJDZHIIK-ADRDWWJJSA-N
methyldopate	CJCSPKMFHVPWAR-JTQLQIEISA-N
pentolonium	XSBSKEQEUFOSDD-UHFFFAOYSA-N
cyproterone	DUSHUSLJJMDGTE-ZJPMUUANSA-N
prednisone	XOFYZVNMUHMLCC-ZPOLXVRWSA-N
alprenolol	PAZJSJFMUHDSTF-UHFFFAOYSA-N
clenbuterol	STJMRWALKKWQGH-UHFFFAOYSA-N
procaine	MFDFERRIHVXMIY-UHFFFAOYSA-N
delsoline	JVBLTQQBEQQLEV-UHFFFAOYSA-N	JVBLTQQBEQQLEV-QWXNQNADSA-N	JVBLTQQBEQQLEV-UJQKCMHTSA-N	JVBLTQQBEQQLEV-YAEAOFIFSA-N	JVBLTQQBEQQLEV-JXXBMRSMSA-N
rosiglitazone	YASAKCUCGLMORW-UHFFFAOYSA-N
azacyclonol	ZMISODWVFHHWNR-UHFFFAOYSA-N
diazoxide	GDLBFKVLRPITMI-UHFFFAOYSA-N
benzthiazide	NDTSRXAMMQDVSW-UHFFFAOYSA-N
tanespimycin	AYUNIORJHRXIBJ-TXHRRWQRSA-N
meteneprost	WMLGLMGSFIXSGO-KTXJXPLISA-N
diphemanil_metilsulfate	
drofenine	AGJBLWCLQCKRJP-UHFFFAOYSA-N
zidovudine	HBOMLICNUCNMMY-XLPZGREQSA-N
etilefrine	SQVIAVUSQAWMKL-UHFFFAOYSA-N
tremorine	JSUAJTLKVREZHV-UHFFFAOYSA-N
bumetanide	MAEIEVLCKWDQJH-UHFFFAOYSA-N
mestranol	IMSSROKUHAOUJS-MJCUULBUSA-N
leflunomide	VHOGYURTWQBHIL-UHFFFAOYSA-N
buflomedil	OWYLAEYXIQKAOL-UHFFFAOYSA-N
tobramycin	NLVFBUXFDBBNBW-PBSUHMDJSA-N	NLVFBUXFDBBNBW-PBSUHMDJSA-S
luteolin	IQPNAANSBPBGFQ-UHFFFAOYSA-N
pergolide	YEHCICAEULNIGD-MZMPZRCHSA-N
fulvestrant	VWUXBMIQPBEWFH-WCCTWKNTSA-N
metoprolol	IUBSYMUCCVWXPE-UHFFFAOYSA-N
flumetasone	WXURHACBFYSXBI-GQKYHHCASA-N
pizotifen	FIADGNVRKBPQEU-UHFFFAOYSA-N
5182598	
nilutamide	XWXYUMMDTVBTOU-UHFFFAOYSA-N
meticrane	FNQQBFNIYODEMB-UHFFFAOYSA-N
rescinnamine	SZLZWPPUNLXJEA-QEGASFHISA-N	SZLZWPPUNLXJEA-JXMROGBWSA-N	SZLZWPPUNLXJEA-LAFLMMDJSA-N	SZLZWPPUNLXJEA-UHFFFAOYSA-N
nifedipine	HYIMSNHJOBLJNT-UHFFFAOYSA-N
isoniazid	QRXWMOHMRWLFEY-UHFFFAOYSA-N
erastin	BKQFRNYHFIQEKN-UHFFFAOYSA-N
pepstatin	FAXGPCHRFPCXOO-LXTPJMTPSA-N
CP-645525-01	FERWBXLFSBWTDE-UHFFFAOYSA-N
lomustine	GQYIWUVLTXOXAJ-UHFFFAOYSA-N
mifepristone	VKHAHZOOUSRJNA-GCNJZUOMSA-N
triamcinolone	GFNANZIMVAIWHM-OBYCQNJPSA-N
chlorphenamine	SOYKEARSMXGVTM-UHFFFAOYSA-N
imidurea	ZCTXEAQXZGPWFG-UHFFFAOYSA-N
mebendazole	OPXLLQIJSORQAM-UHFFFAOYSA-N
nicergoline	YSEXMKHXIOCEJA-FVFQAYNVSA-N
propranolol	AQHHHDLHHXJYJD-UHFFFAOYSA-N
Hippeastrine hydrobromide 	JXIXDPWKBCBXEY-QEPVQFSESA-N
0198306-0000	
bendroflumethiazide	HDWIHXWEUNVBIY-UHFFFAOYSA-N
docosahexaenoic_acid_ethyl_ester	
harmine	BXNJHAXVSOCGBA-UHFFFAOYSA-N
pentoxifylline	BYPFEZZEUUWMEJ-UHFFFAOYSA-N
cyclopenthiazide	BKYKPTRYDKTTJY-UHFFFAOYSA-N
sulmazole	XMFCOYRWYYXZMY-UHFFFAOYSA-N
scopolamine_N-oxide	
cotinine	UIKROCXWUNQSPJ-VIFPVBQESA-N
etomidate	NPUKDXXFDDZOKR-LLVKDONJSA-N	NPUKDXXFDDZOKR-UHFFFAOYSA-N	NPUKDXXFDDZOKR-NSHDSACASA-N
conessine	GPLGAQQQNWMVMM-MYAJQUOBSA-N
fenofibrate	YMTINGFKWWXKFG-UHFFFAOYSA-N
ornidazole	IPWKIXLWTCNBKN-UHFFFAOYSA-N
pentoxyverine	CFJMRBQWBDQYMK-UHFFFAOYSA-N
trihexyphenidyl	HWHLPVGTWGOCJO-UHFFFAOYSA-N
H-89	GELOGQJVGPIKAM-WTVBWJGASA-N	ZKZXNDJNWUTGDK-NSCUHMNNSA-N
corticosterone	OMFXVFTZEKFJBZ-HJTSIMOOSA-N
CP-863187	UACOXBQBNWQWOK-UHFFFAOYSA-N
quinostatin	
Dubinidine 	NETGEQWGGLFVRL-UHFFFAOYSA-N
furosemide	ZZUFCTLCJUWOSV-UHFFFAOYSA-N
cytochalasin_B	
5155877	
articaine	QTGIAADRBBLJGA-UHFFFAOYSA-N
metampicillin	FZECHKJQHUVANE-MCYUEQNJSA-N
proxyphylline	KYHQZNGJUGFTGR-UHFFFAOYSA-N
dinoprostone	XEYBRNLFEZDVAW-ARSRFYASSA-N
molindone	KLPWJLBORRMFGK-UHFFFAOYSA-N
meclozine	OCJYIGYOJCODJL-UHFFFAOYSA-N
pyrvinium	QMHSXPLYMTVAMK-UHFFFAOYSA-N
bepridil	UIEATEWHFDRYRU-UHFFFAOYSA-N
dimenhydrinate	NFLLKCVHYJRNRH-UHFFFAOYSA-N
PF-00539758-00	TVLZPUGUNYKQRR-UHFFFAOYSA-N
desipramine	HCYAFALTSJYZDH-UHFFFAOYSA-N
physostigmine	PIJVFDBKTWXHHD-HIFRSBDPSA-N
probucol	FYPMFJGVHOHGLL-UHFFFAOYSA-N
cycloserine	DYDCUQKUCUHJBH-UWTATZPHSA-N
glipizide	ZJJXGWJIGJFDTL-UHFFFAOYSA-N
Fillalbin 	OZKTVDIYALBSMA-UHFFFAOYSA-N
benzathine_benzylpenicillin	
diltiazem	HSUGRBWQSSZJOP-RTWAWAEBSA-N
calcium_pantothenate	
bisoprolol	VHYCDWMUTMEGQY-UHFFFAOYSA-N
altretamine	UUVWYPNAQBNQJQ-UHFFFAOYSA-N
orlistat	AHLBNYSZXLDEJQ-FWEHEUNISA-N
liothyronine	AUYYCJSJGJYCDS-LBPRGKRZSA-N
carbimazole	CFOYWRHIYXMDOT-UHFFFAOYSA-N
BCB000040	
tolazoline	JIVZKJJQOZQXQB-UHFFFAOYSA-N
nortriptyline	PHVGLTMQBUFIQQ-UHFFFAOYSA-N
ondansetron	FELGMEQIXOGIFQ-UHFFFAOYSA-N
gramine	OCDGBSUVYYVKQZ-UHFFFAOYSA-N
atracurium_besilate	
betaxolol	NWIUTZDMDHAVTP-UHFFFAOYSA-N
adiphenine	JGOAIQNSOGZNBX-UHFFFAOYSA-N
tranylcypromine	AELCINSCMGFISI-UHFFFAOYSA-N	AELCINSCMGFISI-YGPZHTELSA-N	AELCINSCMGFISI-DTWKUNHWSA-N
methazolamide	FLOSMHQXBMRNHR-UHFFFAOYSA-N
fenbufen	ZPAKPRAICRBAOD-UHFFFAOYSA-N
hecogenin	QOLRLLFJMZLYQJ-QVZLHOKISA-N	QOLRLLFJMZLYQJ-UHFFFAOYSA-N	QOLRLLFJMZLYQJ-LOBDNJQFSA-N	QOLRLLFJMZLYQJ-BMYFWTKCSA-N	QOLRLLFJMZLYQJ-AOHUWMDTSA-N	QOLRLLFJMZLYQJ-SURYOTBUSA-N
citalopram	WSEQXVZVJXJVFP-UHFFFAOYSA-N
myricetin	IKMDFBPHZNJCSN-UHFFFAOYSA-N
iobenguane	PDWUPXJEEYOOTR-UHFFFAOYSA-N
salsolinol	IBRKLUSXDYATLG-LURJTMIESA-N
demecolcine	NNJPGOLRFBJNIW-UHFFFAOYSA-N	NNJPGOLRFBJNIW-HNNXBMFYSA-N
raloxifene	GZUITABIAKMVPG-UHFFFAOYSA-N
hydrochlorothiazide	JZUFKLXOESDKRF-UHFFFAOYSA-N
digoxin	LTMHDMANZUZIPE-PUGKRICDSA-N
epiandrosterone	QGXBDMJGAMFCBF-LUJOEAJASA-N
novobiocin	YJQPYGGHQPGBLI-KGSXXDOSSA-N
ipratropium_bromide	
etamivan	BQJODPIMMWWMFC-UHFFFAOYSA-N
rifampicin	FZYOVNIOYYPUPY-JFXANHDQSA-N	FZYOVNIOYYPUPY-LJJLNQMFSA-N	FZYOVNIOYYPUPY-AMSHPFMVSA-N	FZYOVNIOYYPUPY-NQUZFYFYSA-N	FZYOVNIOYYPUPY-ADIQJEEPSA-N	FZYOVNIOYYPUPY-UXKYPCFPSA-N	FZYOVNIOYYPUPY-ZTWDQPHTSA-N	FZYOVNIOYYPUPY-CIVVJLCCSA-N	FZYOVNIOYYPUPY-UHFFFAOYSA-N	FZYOVNIOYYPUPY-HEGPSGTHSA-N	FZYOVNIOYYPUPY-AAHSBGALSA-N
edrophonium_chloride	
cefadroxil	BOEGTKLJZSQCCD-UEKVPHQBSA-N
SR-95639A	LAROMNHHFPRNET-UHFFFAOYSA-N
U0125	AVMMKRWZZLXNPR-LINYASERSA-N
picotamide	KYWCWBXGRWWINE-UHFFFAOYSA-N
josamycin	XJSFLOJWULLJQS-NGVXBBESSA-N	XJSFLOJWULLJQS-LIACPWMRSA-N	XJSFLOJWULLJQS-DJBGMQKKSA-N	XJSFLOJWULLJQS-ZQXIYRAGSA-N	XJSFLOJWULLJQS-XRUKWLHHSA-N	XJSFLOJWULLJQS-HTYUZQQASA-N
aminohippuric_acid	
gabapentin	UGJMXCAKCUNAIE-UHFFFAOYSA-N
solasodine	KWVISVAMQJWJSZ-TUFZIJDDSA-N	KWVISVAMQJWJSZ-WUBAUXGGSA-N	KWVISVAMQJWJSZ-CHYQBTONSA-N	KWVISVAMQJWJSZ-MEPOCMDBSA-N	KWVISVAMQJWJSZ-UHFFFAOYSA-N	KWVISVAMQJWJSZ-HCNCMGDQSA-N	KWVISVAMQJWJSZ-VKROHFNGSA-N	KWVISVAMQJWJSZ-DXZIWIJNSA-N
5186324	
procarbazine	CPTBDICYNRMXFX-UHFFFAOYSA-N
nomifensine	XXPANQJNYNUNES-UHFFFAOYSA-N
ioxaglic_acid	
pirlindole	IWVRVEIKCBFZNF-UHFFFAOYSA-N
albendazole	HXHWSAZORRCQMX-UHFFFAOYSA-N
hydroxyachillin	YMUOZXZDDBRJEP-UHFFFAOYSA-N
probenecid	DBABZHXKTCFAPX-UHFFFAOYSA-N
acemetacin	FSQKKOOTNAMONP-UHFFFAOYSA-N
fisetin	XHEFDIBZLJXQHF-UHFFFAOYSA-N
pyridoxine	LXNHXLLTXMVWPM-UHFFFAOYSA-N
dopamine	VYFYYTLLBUKUHU-UHFFFAOYSA-N
N-acetylmuramic_acid	
diflorasone	WXURHACBFYSXBI-XHIJKXOTSA-N
omeprazole	SUBDBMMJDZJVOS-UHFFFAOYSA-N
harmalol	CRQDWQWZCNKKAC-UHFFFAOYSA-N
atropine_methonitrate	
thioproperazine	VZYCZNZBPPHOFY-UHFFFAOYSA-N
propylthiouracil	KNAHARQHSZJURB-UHFFFAOYSA-N
clorgiline	BTFHLQRNAMSNLC-UHFFFAOYSA-N
laudanosine	KGPAYJZAMGEDIQ-UHFFFAOYSA-N
berberine	YBHILYKTIRIUTE-UHFFFAOYSA-N
azathioprine	LMEKQMALGUDUQG-UHFFFAOYSA-N
cinchonidine	KMPWYEUPVWOPIM-CZHSWUJBSA-N	KMPWYEUPVWOPIM-MMHYOFHDSA-N	KMPWYEUPVWOPIM-KODHJQJWSA-N	KMPWYEUPVWOPIM-AREIWFIDSA-N	KMPWYEUPVWOPIM-YNRGSOABSA-N	KMPWYEUPVWOPIM-BDHCGPDFSA-N	KMPWYEUPVWOPIM-UHFFFAOYSA-N	KMPWYEUPVWOPIM-SPLQCWDRSA-N	KMPWYEUPVWOPIM-HVIVRAMPSA-N
BCB000039	
iopromide	DGAIEPBNLOQYER-UHFFFAOYSA-N
dinoprost	PXGPLTODNUVGFL-YNNPMVKQSA-N
naphazoline	CNIIGCLFLJGOGP-UHFFFAOYSA-N
tiapride	JTVPZMFULRWINT-UHFFFAOYSA-N
prednicarbate	FNPXMHRZILFCKX-KAJVQRHHSA-N
glibenclamide	ZNNLBTZKUZBEKO-UHFFFAOYSA-N
chenodeoxycholic_acid	
mebhydrolin	FQQIIPAOSKSOJM-UHFFFAOYSA-N
nimodipine	UIAGMCDKSXEBJQ-UHFFFAOYSA-N
selegiline	MEZLKOACVSPNER-GFCCVEGCSA-N
enoxacin	IDYZIJYBMGIQMJ-UHFFFAOYSA-N
hyoscyamine	RKUNBYITZUJHSG-PJPHBNEVSA-N	RKUNBYITZUJHSG-PRLABOORSA-N	RKUNBYITZUJHSG-AUSYRVNMSA-N	RKUNBYITZUJHSG-UHFFFAOYSA-N	RKUNBYITZUJHSG-VFSICIBPSA-N	RKUNBYITZUJHSG-LGGPCSOHSA-N
levamisole	HLFSDGLLUJUHTE-SNVBAGLBSA-N
alpha-yohimbine	BLGXFZZNTVWLAY-DIRVCLHFSA-N	BLGXFZZNTVWLAY-LSJCQCDQSA-N
tiletamine	QAXBVGVYDCAVLV-UHFFFAOYSA-N
hexetidine	DTOUUUZOYKYHEP-UHFFFAOYSA-N
beta-escin	AXNVHPCVMSNXNP-ZELRDNAQSA-N	PILQWZHCDDQXGP-MLHWAQRKSA-N	AXNVHPCVMSNXNP-UHFFFAOYSA-N	YFESOSRPNPYODN-LNXBMLMBSA-N	CVBMAZKKCSYWQR-WCGOZPBSSA-N	AXNVHPCVMSNXNP-YSYFQUGBSA-N	OTMSDBZUPAUEDD-UHFFFAOYSA-N	VSRMYECBCGPXAW-SIVHJCNUSA-N	AXNVHPCVMSNXNP-LGWBRZJHSA-N
PHA-00665752	OYONTEXKYJZFHA-MVUTXWCHSA-N
propidium_iodide	
dantrolene	OZOMQRBLCMDCEG-VIZOYTHASA-N
ketotifen	ZCVMWBYGMWKGHF-UHFFFAOYSA-N
quercetin	REFJWTPEDVJJIY-UHFFFAOYSA-N
niridazole	RDXLYGJSWZYTFJ-UHFFFAOYSA-N
prazosin	IENZQIKPVFGBNW-UHFFFAOYSA-N
isocorydine	QELDJEKNFOQJOY-ZDUSSCGKSA-N
gentamicin	CEAZRRDELHUEMR-UHFFFAOYSA-N
5248896	
amiprilose	RJNRORZRFGUAKL-ADMBVFOFSA-N	YXBQLONCIPUQKO-UJPOAAIJSA-N
methyldopa	CJCSPKMFHVPWAR-JTQLQIEISA-N
danazol	POZRVZJJTULAOH-LHZXLZLDSA-N
furaltadone	YVQVOQKFMFRVGR-VGOFMYFVSA-N
etynodiol	JYILPERKVHXLNF-QMNUTNMBSA-N	ONKUMRGIYFNPJW-KIEAKMPYSA-N
ketoprofen	DKYWVDODHFEZIM-UHFFFAOYSA-N
metolazone	AQCHWTWZEMGIFD-UHFFFAOYSA-N
ethotoin	SZQIFWWUIBRPBZ-UHFFFAOYSA-N
piperacillin	IVBHGBMCVLDMKU-GXNBUGAJSA-N
fenoterol	LSLYOANBFKQKPT-UHFFFAOYSA-N
16,16-dimethylprostaglandin_E2	
benzydamine	CNBGNNVCVSKAQZ-UHFFFAOYSA-N
dydrogesterone	JGMOKGBVKVMRFX-HQZYFCCVSA-N
tetraethylenepentamine	FAGUFWYHJQFNRV-UHFFFAOYSA-N
oleandomycin	RZPAKFUAFGMUPI-MRJOUTSESA-N	RZPAKFUAFGMUPI-UHFFFAOYSA-N	RZPAKFUAFGMUPI-ZRLKJDMJSA-N	RZPAKFUAFGMUPI-UQXMPEMXSA-N	RZPAKFUAFGMUPI-QESOVKLGSA-N	RZPAKFUAFGMUPI-KGIGTXTPSA-N
AG-028671	ZILKVIBMYOWXDW-UHFFFAOYSA-N
iloprost	HIFJCPQKFCZDDL-SGSAMSKHSA-N	HIFJCPQKFCZDDL-UGQITTIWSA-N	HIFJCPQKFCZDDL-CSAIKYROSA-N	HIFJCPQKFCZDDL-ACWOEMLNSA-N	HIFJCPQKFCZDDL-UHFFFAOYSA-N
vigabatrin	PJDFLNIOAUIZSL-UHFFFAOYSA-N
enilconazole	PZBPKYOVPCNPJY-UHFFFAOYSA-N
spectinomycin	UNFWWIHTNXNPBV-WXKVUWSESA-N
Graveoline 	COBBNRKBTCBWQP-UHFFFAOYSA-N
chlorpromazine	ZPEIMTDSQAKGNT-UHFFFAOYSA-N
mevalolactone	
PNU-0230031	GTGUASNSWNNGBP-UHFFFAOYSA-N
topiramate	KJADKKWYZYXHBB-XBWDGYHZSA-N
clomipramine	GDLIGKIOYRNHDA-UHFFFAOYSA-N
W-13	JJQKICOADUKSNS-UHFFFAOYSA-N	QKAALLVQBOLELJ-UHFFFAOYSA-N
famotidine	XUFQPHANEAPEMJ-UHFFFAOYSA-N
piracetam	GMZVRMREEHBGGF-UHFFFAOYSA-N
daunorubicin	STQGQHZAVUOBTE-VGBVRHCVSA-N
oxybuprocaine	CMHHMUWAYWTMGS-UHFFFAOYSA-N
thioridazine	KLBQZWRITKRQQV-UHFFFAOYSA-N
mimosine	WZNJWVWKTVETCG-UHFFFAOYSA-N
betonicine	MUNWAHDYFVYIKH-UHFFFAOYSA-N	MUNWAHDYFVYIKH-NTSWFWBYSA-N	MUNWAHDYFVYIKH-WDSKDSINSA-N	MUNWAHDYFVYIKH-RITPCOANSA-N
morantel	NVEPPWDVLBMNMB-SNAWJCMRSA-N
0316684-0000	
valproic_acid	
lymecycline	PZTCVADFMACKLU-UNKJSYSHSA-N	PZTCVADFMACKLU-UEPZRUIBSA-N	PZTCVADFMACKLU-CCZWQWCCSA-N
mometasone	QLIIKPVHVRXHRI-CXSFZGCWSA-N	QLIIKPVHVRXHRI-KPZMXUCXSA-N
bupivacaine	LEBVLXFERQHONN-UHFFFAOYSA-N
harmol	LBBJNGFCXDOYMQ-UHFFFAOYSA-N
oxedrine	YRCWQPVGYLYSOX-UHFFFAOYSA-N
xylometazoline	HUCJFAOMUPXHDK-UHFFFAOYSA-N
sulfapyridine	GECHUMIMRBOMGK-UHFFFAOYSA-N
dizocilpine	LBOJYSIDWZQNJS-CVEARBPZSA-N	LBOJYSIDWZQNJS-JKSUJKDBSA-N	LBOJYSIDWZQNJS-UHFFFAOYSA-N
racecadotril	ODUOJXZPIYUATO-UHFFFAOYSA-N
labetalol	SGUAFYQXFOLMHL-UHFFFAOYSA-N
monocrotaline	QVCMHGGNRFRMAD-XFGHUUIASA-N
methylergometrine	UNBRKDKAWYKMIV-QWQRMKEZSA-N
oxaprozin	OFPXSFXSNFPTHF-UHFFFAOYSA-N
etoposide	VJJPUSNTGOMMGY-GEGAHKOSSA-N	VJJPUSNTGOMMGY-ZURUWIRVSA-N	VJJPUSNTGOMMGY-PJVTZUROSA-N	VJJPUSNTGOMMGY-BQZFVAJISA-N	VJJPUSNTGOMMGY-SEMSPOPGSA-N	VJJPUSNTGOMMGY-NBJJDLTASA-N	VJJPUSNTGOMMGY-MRVIYFEKSA-N	VJJPUSNTGOMMGY-NMTYGFQJSA-N	VJJPUSNTGOMMGY-XOKDPUQFSA-N	VJJPUSNTGOMMGY-LBYSYZCZSA-N	VJJPUSNTGOMMGY-PTNNUCCUSA-N	VJJPUSNTGOMMGY-UHFFFAOYSA-N	VJJPUSNTGOMMGY-MRAJQDPKSA-N
diclofenamide	GJQPMPFPNINLKP-UHFFFAOYSA-N
phenoxybenzamine	QZVCTJOXCFMACW-UHFFFAOYSA-N
metyrapone	FJLBFSROUSIWMA-UHFFFAOYSA-N
lansoprazole	MJIHNNLFOKEZEW-UHFFFAOYSA-N
gelsemine	NFYYATWFXNPTRM-WKRGLROPSA-N	NFYYATWFXNPTRM-ICFOCEFXSA-N	NFYYATWFXNPTRM-ZIWPNRSCSA-N	NFYYATWFXNPTRM-UHFFFAOYSA-N	NFYYATWFXNPTRM-GQZGOOQKSA-N	NFYYATWFXNPTRM-VUMTWQQNSA-N	NFYYATWFXNPTRM-BOCRADAPSA-N	NFYYATWFXNPTRM-QJICHLCESA-N	NFYYATWFXNPTRM-CLIGSAHWSA-N
phthalylsulfathiazole	PBMSWVPMRUJMPE-UHFFFAOYSA-N
diclofenac	DCOPUUMXTXDBNB-UHFFFAOYSA-N
dobutamine	JRWZLRBJNMZMFE-UHFFFAOYSA-N
palmatine	QUCQEUCGKKTEBI-UHFFFAOYSA-N
dexamethasone	UREBDLICKHMUKA-CXSFZGCWSA-N
mycophenolic_acid	
vincamine	RXPRRQLKFXBCSJ-GIVPXCGWSA-N
calcium_folinate	
metronidazole	VAOCPAMSLUNLGC-UHFFFAOYSA-N
AR-A014418	YAEMHJKFIIIULI-UHFFFAOYSA-N
fluvoxamine	CJOFXWAVKWHTFT-XSFVSMFZSA-N
fusidic_acid	
dicloxacillin	YFAGHNZHGGCZAX-JKIFEVAISA-N
butamben	IUWVALYLNVXWKX-UHFFFAOYSA-N
sulfadimethoxine	ZZORFUFYDOWNEF-UHFFFAOYSA-N
fasudil	LFVPBERIVUNMGV-UHFFFAOYSA-N	NOXXIYDYFSNHDF-UHFFFAOYSA-N	NGOGFTYYXHNFQH-UHFFFAOYSA-N
1,4-chrysenequinone	UORKIKBNUWJNJF-UHFFFAOYSA-N
alclometasone	FJXOGVLKCZQRDN-PHCHRAKRSA-N
sulfabenzamide	PBCZLFBEBARBBI-UHFFFAOYSA-N
tetracaine	GKCBAIGFKIBETG-UHFFFAOYSA-N
todralazine	WGZDBVOTUVNQFP-UHFFFAOYSA-N
practolol	DURULFYMVIFBIR-UHFFFAOYSA-N
quinpirole	FTSUPYGMFAPCFZ-ZWNOBZJWSA-N
pivampicillin	ZEMIJUDPLILVNQ-ZXFNITATSA-N
methoxsalen	QXKHYNVANLEOEG-UHFFFAOYSA-N
sulfadimidine	ASWVTGNCAZCNNR-UHFFFAOYSA-N
estropipate	HZEQBCVBILBTEP-ZFINNJDLSA-N
cortisone	MFYSYFVPBJMHGN-ZPOLXVRWSA-N
bephenium_hydroxynaphthoate	
denatonium_benzoate	
thioguanosine	OTDJAMXESTUWLO-UUOKFMHZSA-N	CEMWFPKZUAKCRS-GWTDSMLYSA-N
cyclizine	UVKZSORBKUEBAZ-UHFFFAOYSA-N
beclometasone	NBMKJKDGKREAPL-DVTGEIKXSA-N
demecarium_bromide	
etodolac	NNYBQONXHNTVIJ-UHFFFAOYSA-N
alimemazine	ZZHLYYDVIOPZBE-UHFFFAOYSA-N
methapyrilene	HNJJXZKZRAWDPF-UHFFFAOYSA-N
mepyramine	YECBIJXISLIIDS-UHFFFAOYSA-N
ribostamycin	NSKGQURZWSPSBC-NLZFXWNVSA-N	NSKGQURZWSPSBC-VVPCINPTSA-N	NSKGQURZWSPSBC-UHFFFAOYSA-N
decamethonium_bromide	
fludroxycortide	POPFMWWJOGLOIF-XWCQMRHXSA-N
5279552	
trifluoperazine	ZEWQUBUPAILYHI-UHFFFAOYSA-N
(-)-atenolol	METKIMKYRPQLGS-LBPRGKRZSA-N
mitoxantrone	KKZJGLLVHKMTCM-UHFFFAOYSA-N
naltrexone	DQCKKXVULJGBQN-XFWGSAIBSA-N
doxepin	ODQWQRRAPPTVAG-UHFFFAOYSA-N	ODQWQRRAPPTVAG-GZTJUZNOSA-N	ODQWQRRAPPTVAG-BOPFTXTBSA-N
isoetarine	HUYWAWARQUIQLE-UHFFFAOYSA-N
proadifen	FHIKZROVIDCMJA-UHFFFAOYSA-N	SNTQPLDRUZOSDP-UHFFFAOYSA-N
hymecromone	HSHNITRMYYLLCV-UHFFFAOYSA-N
griseofulvin	DDUHZTYCFQRHIY-RBHXEPJQSA-N
N6-methyladenosine	VQAYFKKCNSOZKM-IOSLPCCCSA-N
guanfacine	INJOMKTZOLKMBF-UHFFFAOYSA-N
ellipticine	CTSPAMFJBXKSOY-UHFFFAOYSA-N
chlortetracycline	DHPRQBPJLMKORJ-BLJISXJUSA-N	DHPRQBPJLMKORJ-RQWFMOQPSA-N	DHPRQBPJLMKORJ-UHFFFAOYSA-N	DHPRQBPJLMKORJ-XRNKAMNCSA-N
mephenytoin	GMHKMTDVRCWUDX-UHFFFAOYSA-N
Trolox_C	GLEVLJDDWXEYCO-UHFFFAOYSA-N
amodiaquine	OVCDSSHSILBFBN-UHFFFAOYSA-N
butyl_hydroxybenzoate	
tacrolimus	QJJXYPPXXYFBGM-LFZNUXCKSA-N
milrinone	PZRHRDRVRGEVNW-UHFFFAOYSA-N
pirinixic_acid	
ajmaline	CJDRUOGAGYHKKD-IWMNNKGHSA-N	CJDRUOGAGYHKKD-GNTWRGKJSA-N	CJDRUOGAGYHKKD-TYHHOCDDSA-N	CJDRUOGAGYHKKD-SXKXKDIKSA-N	CJDRUOGAGYHKKD-UORGRDHFSA-N	CJDRUOGAGYHKKD-OVXZWHIBSA-N	CJDRUOGAGYHKKD-HEFSZTOGSA-N	CJDRUOGAGYHKKD-ZPRZLSKBSA-N	CJDRUOGAGYHKKD-FCXWBZPOSA-N	CJDRUOGAGYHKKD-VNZPNFOASA-N	CJDRUOGAGYHKKD-TXDKXUJTSA-N	CJDRUOGAGYHKKD-FYGXBCQKSA-N	CJDRUOGAGYHKKD-FUIWMBJSSA-N	CJDRUOGAGYHKKD-PMSQXURASA-N	CJDRUOGAGYHKKD-KIZBXWFUSA-N	CJDRUOGAGYHKKD-BAXQIEGASA-N	CJDRUOGAGYHKKD-UHFFFAOYSA-N
butoconazole	SWLMUYACZKCSHZ-UHFFFAOYSA-N
16-phenyltetranorprostaglandin_E2	
reserpine	QEVHRUUCFGRFIF-MDEJGZGSSA-N
propoxycaine	CAJIGINSTLKQMM-UHFFFAOYSA-N
amiloride	XSDQTOBWRPYKKA-UHFFFAOYSA-N
foliosidine	IUPYLWAXGAJZQC-UHFFFAOYSA-N
clidinium_bromide	
naftidrofuryl	KBAFPSLPKGSANY-UHFFFAOYSA-N
kinetin	QANMHLXAZMSUEX-UHFFFAOYSA-N
betulin	FVWJYYTZTCVBKE-ROUWMTJPSA-N
tetroquinone	DGQOCLATAPFASR-UHFFFAOYSA-N
nadide	JGDBMKCWNRCIFX-QYZPTAICSA-N	BAWFJGJZGIEFAR-NNYOXOHSSA-N	BAWFJGJZGIEFAR-NNYOXOHSSA-O
sirolimus	QFJCIRLUMZQUOT-WMVIXHMVSA-N	QFJCIRLUMZQUOT-RIPNRHRMSA-N	QFJCIRLUMZQUOT-SWBOGZMGSA-N	QFJCIRLUMZQUOT-NLPZOAPNSA-N	QFJCIRLUMZQUOT-HPLJOQBZSA-N	QFJCIRLUMZQUOT-BLBZBZKNSA-N	QFJCIRLUMZQUOT-KADBNGAOSA-N	QFJCIRLUMZQUOT-XRDCAIOLSA-N	QFJCIRLUMZQUOT-ADLMHZFOSA-N	QFJCIRLUMZQUOT-QERAZRLGSA-N	QFJCIRLUMZQUOT-MQWRTCEJSA-N	QFJCIRLUMZQUOT-NUGANYOESA-N
3-acetamidocoumarin	XJYLCCJIDYSFMB-UHFFFAOYSA-N
minoxidil	ZIMGGGWCDYVHOY-UHFFFAOYSA-N
rolitetracycline	IKQRPFTXKQQLJF-UKTGLLKZSA-N	IKQRPFTXKQQLJF-IAHYZSEUSA-N	IKQRPFTXKQQLJF-VQCPGFMQSA-N
0175029-0000	
naringin	DFPMSGMNTNDNHN-JJLSSNRUSA-N	DFPMSGMNTNDNHN-NPDMSNFISA-N	DFPMSGMNTNDNHN-UHFFFAOYSA-N	DFPMSGMNTNDNHN-BRZCDTLOSA-N	DFPMSGMNTNDNHN-ILUPNGPDSA-N	DFPMSGMNTNDNHN-CSIAVLANSA-N	DFPMSGMNTNDNHN-ZPHOTFPESA-N
niclosamide	RJMUSRYZPJIFPJ-UHFFFAOYSA-N
syrosingopine	ZCDNRPPFBQDQHR-SSYATKPKSA-N
boldine	LZJRNLRASBVRRX-UHFFFAOYSA-N	LZJRNLRASBVRRX-ZDUSSCGKSA-N
chlortalidone	JIVPVXMEBJLZRO-UHFFFAOYSA-N
hexylcaine	DKLKMKYDWHYZTD-UHFFFAOYSA-N
metanephrine	JWJCTZKFYGDABJ-UHFFFAOYSA-N
brompheniramine	ZDIGNSYAACHWNL-UHFFFAOYSA-N
methylbenzethonium_chloride	
flutamide	MKXKFYHWDHIYRV-UHFFFAOYSA-N
clomifene	GKIRPKYJQBWNGO-QPLCGJKRSA-N	GKIRPKYJQBWNGO-UHFFFAOYSA-N	GKIRPKYJQBWNGO-OCEACIFDSA-N
staurosporine	HKSZLNNOFSGOKW-VCPDCAFQSA-N	HKSZLNNOFSGOKW-UHFFFAOYSA-N	HKSZLNNOFSGOKW-UCBFMKAXSA-N	HKSZLNNOFSGOKW-UUUCIFKISA-N	HKSZLNNOFSGOKW-HOWPHSCPSA-N	HKSZLNNOFSGOKW-HMWZOHBLSA-N	HKSZLNNOFSGOKW-GKHVWRADSA-N	HKSZLNNOFSGOKW-FYTWVXJKSA-N	HKSZLNNOFSGOKW-ZGQXJOJZSA-N	HKSZLNNOFSGOKW-VYEKLMEQSA-N
guanadrel	HPBNRIOWIXYZFK-UHFFFAOYSA-N
ribavirin	IWUCXVSUMQZMFG-AFCXAGJDSA-N
lidocaine	NNJVILVZKWQKPM-UHFFFAOYSA-N
terconazole	BLSQLHNBWJLIBQ-OZXSUGGESA-N
monorden	WYZWZEOGROVVHK-ZUVMSYQZSA-N	WYZWZEOGROVVHK-HZDAAVBUSA-N	WYZWZEOGROVVHK-GTMNPGAYSA-N	WYZWZEOGROVVHK-JVLMNHKTSA-N	WYZWZEOGROVVHK-WSGSENCDSA-N	WYZWZEOGROVVHK-HBUVGVEXSA-N
oligomycin	MNULEGDCPYONBU-ZUSSGZTJSA-N	MNULEGDCPYONBU-CFSAKFKISA-N	MNULEGDCPYONBU-WMBHJXFZSA-N	MNULEGDCPYONBU-AWJDAWNUSA-N
phenformin	ICFJFFQQTFMIBG-UHFFFAOYSA-N
5162773	
15(S)-15-methylprostaglandin_E2	
zomepirac	ZXVNMYWKKDOREA-UHFFFAOYSA-N
sulfafurazole	NHUHCSRWZMLRLA-UHFFFAOYSA-N
droperidol	RMEDXOLNCUSCGS-UHFFFAOYSA-N
dl-alpha_tocopherol	
5252917	
methacholine_chloride	
isocarboxazid	XKFPYPQQHFEXRZ-UHFFFAOYSA-N
noscapine	AKNNEGZIBPJZJG-MSOLQXFVSA-N
dirithromycin	WLOHNSSYAXHWNR-PBIGORBISA-N	WLOHNSSYAXHWNR-UHFFFAOYSA-N	WLOHNSSYAXHWNR-GETPLZSYSA-N	WLOHNSSYAXHWNR-JFSYMESMSA-N	WLOHNSSYAXHWNR-ACXHRFKYSA-N	WLOHNSSYAXHWNR-NXPDYKKBSA-N	WLOHNSSYAXHWNR-DWIOZXRMSA-N	WLOHNSSYAXHWNR-TUMOPFDVSA-N	WLOHNSSYAXHWNR-UJLGUNRSSA-N	WLOHNSSYAXHWNR-HXCSUVKKSA-N	WLOHNSSYAXHWNR-UVPJXPSTSA-N	WLOHNSSYAXHWNR-KZYCBHIHSA-N
CP-944629	VNZJNPIWZYMGAO-UHFFFAOYSA-N
sulconazole	AFNXATANNDIXLG-UHFFFAOYSA-N
carbachol	AIXAANGOTKPUOY-UHFFFAOYSA-N
dimethadione	JYJFNDQBESEHJQ-UHFFFAOYSA-N
acebutolol	GOEMGAFJFRBGGG-UHFFFAOYSA-N
bupropion	SNPPWIUOZRMYNY-UHFFFAOYSA-N
oxolamine	IDCHQQSVJAAUQQ-UHFFFAOYSA-N
norfloxacin	OGJPXUAPXNRGGI-UHFFFAOYSA-N
thiamazole	PMRYVIKBURPHAH-UHFFFAOYSA-N
norethisterone	VIKNJXKGJWUCNN-XGXHKTLJSA-N
betahistine	UUQMNUMQCIQDMZ-UHFFFAOYSA-N
6-benzylaminopurine	NWBJYWHLCVSVIJ-UHFFFAOYSA-N
timolol	BLJRIMJGRPQVNF-JTQLQIEISA-N
12,13-EODE	
helveticoside	QBILRDAMJUPXCX-AGAUEGNUSA-N	QBILRDAMJUPXCX-OZJKNARASA-N	QBILRDAMJUPXCX-FBISROKWSA-N
AH-23848	IOFUFYLETVNNRF-OWOJBTEDSA-N	IOFUFYLETVNNRF-OSAZKUMMSA-N
chloropyrazine	GELVZYOEQVJIRR-UHFFFAOYSA-N
bemegride	ORRZGUBHBVWWOP-UHFFFAOYSA-N
minocycline	FFTVPQUHLQBXQZ-KVUCHLLUSA-N
bezafibrate	IIBYAHWJQTYFKB-UHFFFAOYSA-N
pregnenolone	ORNBQBCIOKFOEO-QGVNFLHTSA-N
artemisinin	BLUAFEHZUWYNDE-GEURJLFFSA-N	BLUAFEHZUWYNDE-DCJAHCNHSA-N	BLUAFEHZUWYNDE-UHFFFAOYSA-N	BLUAFEHZUWYNDE-DKGJTOOQSA-N	BLUAFEHZUWYNDE-NNWCWBAJSA-N
strophanthidin	ODJLBQGVINUMMR-HZXDTFASSA-N
promethazine	PWWVAXIEGOYWEE-UHFFFAOYSA-N
isoxsuprine	BMUKKTUHUDJSNZ-UHFFFAOYSA-N
blebbistatin	LZAXPYOBKSJSEX-UHFFFAOYSA-N
adipiodone	FFINMCNLQNTKLU-UHFFFAOYSA-N
vanoxerine	HNLCJXKVYWWDTN-GHRIWEEISA-N	MIBSKSYCRFWIRU-UHFFFAOYSA-N	SOBYTUYXBBGSHH-UHFFFAOYSA-N	HNLCJXKVYWWDTN-LGMDPLHJSA-N	HNLCJXKVYWWDTN-UHFFFAOYSA-N	NAUWTFJOPJWYOT-UHFFFAOYSA-N
ethionamide	AEOCXXJPGCBFJA-UHFFFAOYSA-N
memantine	BUGYDGFZZOZRHP-UHFFFAOYSA-N
bethanechol	NZUPCNDJBJXXRF-UHFFFAOYSA-O
gliquidone	LLJFMFZYVVLQKT-UHFFFAOYSA-N
zoxazolamine	YGCODSQDUUUKIV-UHFFFAOYSA-N
metformin	XZWYZXLIPXDOLR-UHFFFAOYSA-N
cefmetazole	SNBUBQHDYVFSQF-HIFRSBDPSA-N
diphenylpyraline	OWQUZNMMYNAXSL-UHFFFAOYSA-N
cefalonium	FMZXNVLFJHCSAF-DNVCBOLYSA-N
co-dergocrine_mesilate	
epivincamine	RXPRRQLKFXBCSJ-HLAWJBBLSA-N
cinnarizine	DERZBLKQOCDDDZ-JLHYYAGUSA-N
spaglumic_acid	
ivermectin	AZSNMRSAGSSBNP-XPNPUAGNSA-N	AZSNMRSAGSSBNP-ONDMGMIHSA-N	AZSNMRSAGSSBNP-VRFQAOMKSA-N	AZSNMRSAGSSBNP-UHFFFAOYSA-N	AZSNMRSAGSSBNP-ZLRQRZFZSA-N	AZSNMRSAGSSBNP-IPRAJKPQSA-N	AZSNMRSAGSSBNP-KKWNAUQJSA-N	AZSNMRSAGSSBNP-ZGXOMDHGSA-N	AZSNMRSAGSSBNP-NDJJZKGWSA-N	AZSNMRSAGSSBNP-IMXPOURJSA-N	AZSNMRSAGSSBNP-PKKUKZFLSA-N
kanamycin	SBUJHOSQTJFQJX-NOAMYHISSA-N
(-)-isoprenaline	JWZZKOKVBUJMES-NSHDSACASA-N
azapropazone	MPHPHYZQRGLTBO-UHFFFAOYSA-N
flunixin	NOOCSNJCXJYGPE-UHFFFAOYSA-N
perhexiline	CYXKNKQEMFBLER-UHFFFAOYSA-N
GW-8510	GCYXEGSPUDSZJY-PTNGSMBKSA-N
perphenazine	RGCVKNLCSQQDEP-UHFFFAOYSA-N
scoulerine	KNWVMRVOBAFFMH-UHFFFAOYSA-N
pronetalol	HRSANNODOVBCST-UHFFFAOYSA-N
apramycin	XZNUGFQTQHRASN-XZEBHBPDSA-N	XZNUGFQTQHRASN-XYPKRARZSA-N	XZNUGFQTQHRASN-ZDKYEYGDSA-N	XZNUGFQTQHRASN-PSDDYZKFSA-N	XZNUGFQTQHRASN-PHTOHMOASA-N	XZNUGFQTQHRASN-XQENGBIVSA-N
cloxacillin	LQOLIRLGBULYKD-JKIFEVAISA-N
thiethylperazine	XCTYLCDETUVOIP-UHFFFAOYSA-N
amiodarone	IYIKLHRQXLHMJQ-UHFFFAOYSA-N
rimexolone	QTTRZHGPGKRAFB-SNLFSWRFSA-N	QTTRZHGPGKRAFB-OOKHYKNYSA-N	QTTRZHGPGKRAFB-PAIWTFDUSA-N
azlocillin	JTWOMNBEOCYFNV-UHFFFAOYSA-N	JTWOMNBEOCYFNV-XQERAMJGSA-N	JTWOMNBEOCYFNV-NFFDBFGFSA-N	JTWOMNBEOCYFNV-RSUWNVLCSA-N
idazoxan	HPMRFMKYPGXPEP-UHFFFAOYSA-N
DL-thiorphan	LJJKNPQAGWVLDQ-UHFFFAOYSA-N
convolamine	AEFPCFUCFQBXDQ-PBWFPOADSA-N	AEFPCFUCFQBXDQ-UHFFFAOYSA-N
sertaconazole	JLGKQTAYUIMGRK-UHFFFAOYSA-N
flunarizine	SMANXXCATUTDDT-QPJJXVBHSA-N
cisapride	QBYYXIDJOFZORM-UHFFFAOYSA-N	DCSUBABJRXZOMT-UHFFFAOYSA-N
amoxicillin	LSQZJLSUYDQPKJ-NJBDSQKTSA-N
theophylline	ZFXYFBGIUFBOJW-UHFFFAOYSA-N
sulfadoxine	PJSFRIWCGOHTNF-UHFFFAOYSA-N
gallamine_triethiodide	
7-aminocephalosporanic_acid	
triflusal	RMWVZGDJPAKBDE-UHFFFAOYSA-N
pilocarpine	QCHFTSOMWOSFHM-WPRPVWTQSA-N
clorsulon	QOVTVIYTBRHADL-UHFFFAOYSA-N
glycopyrronium_bromide	
isotretinoin	SHGAZHPCJJPHSC-XFYACQKRSA-N
tetrahydroalstonine	GRTOGORTSDXSFK-DLLGKBFGSA-N
pirenperone	HXCNRYXBZNHDNE-UHFFFAOYSA-N
levobunolol	IXHBTMCLRNMKHZ-LBPRGKRZSA-N
mefloquine	XEEQGYMUWCZPDN-IUODEOHRSA-N	XEEQGYMUWCZPDN-UHFFFAOYSA-N	XEEQGYMUWCZPDN-SWLSCSKDSA-N	XEEQGYMUWCZPDN-WFASDCNBSA-N	XEEQGYMUWCZPDN-DOMZBBRYSA-N
furazolidone	PLHJDBGFXBMTGZ-WEVVVXLNSA-N
cefoperazone	GCFBRXLSHGKWDP-XCGNWRKASA-N	GCFBRXLSHGKWDP-UHFFFAOYSA-N	GCFBRXLSHGKWDP-WTKTZPJXSA-N	GCFBRXLSHGKWDP-WJONJSRFSA-N
naftopidil	HRRBJVNMSRJFHQ-UHFFFAOYSA-N
androsterone	QGXBDMJGAMFCBF-HLUDHZFRSA-N
mephentermine	RXQCGGRTAILOIN-UHFFFAOYSA-N
repaglinide	FAEKWTJYAYMJKF-QHCPKHFHSA-N
rofecoxib	RZJQGNCSTQAWON-UHFFFAOYSA-N
chloroquine	WHTVZRBIWZFKQO-UHFFFAOYSA-N
lidoflazine	ZBIAKUMOEKILTF-UHFFFAOYSA-N
sulfadiazine	SEEPANYCNGTZFQ-UHFFFAOYSA-N
(+)-isoprenaline	JWZZKOKVBUJMES-UHFFFAOYSA-N
R-atenolol	
quinethazone	AGMMTXLNIQSRCG-UHFFFAOYSA-N
dexpropranolol	AQHHHDLHHXJYJD-CQSZACIVSA-N
cephaeline	DTGZHCFJNDAHEN-OZEXIGSWSA-N
benzocaine	BLFLLBZGZJTVJG-UHFFFAOYSA-N
roxarsone	XMVJITFPVVRMHC-UHFFFAOYSA-N
ciclopirox	SCKYRAXSEDYPSA-UHFFFAOYSA-N
hydroxyzine	ZQDWXGKKHFNSQK-UHFFFAOYSA-N
dosulepin	PHTUQLWOUWZIMZ-BOPFTXTBSA-N
sulpiride	BGRJTUBHPOOWDU-UHFFFAOYSA-N
propafenone	JWHAUXFOSRPERK-UHFFFAOYSA-N
spironolactone	LXMSZDCAJNLERA-ZHYRCANASA-N
neostigmine_bromide	
procyclidine	WYDUSKDSKCASEF-UHFFFAOYSA-N
cyclobenzaprine	JURKNVYFZMSNLP-UHFFFAOYSA-N
phensuximide	WLWFNJKHKGIJNW-UHFFFAOYSA-N
Epicatechin-(-) 	PFTAWBLQPZVEMU-UKRRQHHQSA-N	PFTAWBLQPZVEMU-DZGCQCFKSA-N
metrifonate	NFACJZMKEDPNKN-UHFFFAOYSA-N
guanethidine	ACGDKVXYNVEAGU-UHFFFAOYSA-N
cefalotin	XIURVHNZVLADCM-IUODEOHRSA-N
tyloxapol	MDYZKJNTKZIUSK-UHFFFAOYSA-N	DZGWFCGJZKJUFP-UHFFFAOYSA-N	UTFVNNPSMPINLE-UHFFFAOYSA-N	XMVBCRTZOPFCFL-UHFFFAOYSA-N	ZLWMZCWKIALKPX-UHFFFAOYSA-N	GWJOFBXSBDVUMH-UHFFFAOYSA-N	ZDDAZGQRVDTIEP-QEXHLBBPSA-N
ranitidine	VMXUWOKSQNHOCA-UKTHLTGXSA-N
fluvastatin	FJLGEFLZQAZZCD-MCBHFWOFSA-N	FJLGEFLZQAZZCD-UHFFFAOYSA-N	FJLGEFLZQAZZCD-VAWYXSNFSA-N	FJLGEFLZQAZZCD-JUFISIKESA-N
nicotinic_acid	
meglumine	MBBZMMPHUWSWHV-BDVNFPICSA-N	MBBZMMPHUWSWHV-UHFFFAOYSA-N
CP-690334-01	VUIJPNCEAKZDCG-UHFFFAOYSA-N
diethylstilbestrol	RGLYKWWBQGJZGM-ISLYRVAYSA-N
ampicillin	AVKUERGKIZMTKX-NJBDSQKTSA-N
digitoxigenin	XZTUSOXSLKTKJQ-CESUGQOBSA-N
clioquinol	QCDFBFJGMNKBDO-UHFFFAOYSA-N
capsaicin	YKPUWZUDDOIDPM-SOFGYWHQSA-N
levodopa	WTDRDQBEARUVNC-LURJTMIESA-N
Vitamin K2 	DKHGMERMDICWDU-GHDNBGIDSA-N	DKHGMERMDICWDU-UHFFFAOYSA-N	PFRQBZFETXBLTP-RCIYGOBDSA-N	DKHGMERMDICWDU-IFQAVNAMSA-N	PTWSIIUEOFZCHW-NTCAYCPXSA-N	JKOZDGHYJBZMGU-GHDNBGIDSA-N	LXKDFTDVRVLXFY-WQWYCSGDSA-N	MJVAVZPDRWSRRC-UHFFFAOYSA-N
Chicago_Sky_Blue_6B	UPKAWFACSJWKND-MAQYYZNPSA-J
pentetic_acid	
indapamide	NDDAHWYSQHTHNT-UHFFFAOYSA-N
N-phenylanthranilic_acid	
PF-00539745-00	
2-aminobenzenesulfonamide	YAZSBRQTAHVVGE-UHFFFAOYSA-N
clebopride	BVPWJMCABCPUQY-UHFFFAOYSA-N
4,5-dianilinophthalimide	AAALVYBICLMAMA-UHFFFAOYSA-N
phenylpropanolamine	DLNKOYKMWOXYQA-VXNVDRBHSA-N
pentamidine	XDRYMKDFEDOLFX-UHFFFAOYSA-N
lithocholic_acid	
amylocaine	FDMBBCOBEAVDAO-UHFFFAOYSA-N
0225151-0000	
alpha-ergocryptine	YDOTUXAWKBPQJW-ISVRSENOSA-N	YDOTUXAWKBPQJW-NSLWYYNWSA-N	YDOTUXAWKBPQJW-UHFFFAOYSA-N
5140203	
enalapril	GBXSMTUPTTWBMN-XIRDDKMYSA-N
lincomycin	OJMMVQQUTAEWLP-UHFFFAOYSA-N	OJMMVQQUTAEWLP-KIDUDLJLSA-N	OJMMVQQUTAEWLP-ZUWRKQLMSA-N	OJMMVQQUTAEWLP-ISVUEQNNSA-N
vinpocetine	DDNCQMVWWZOMLN-IRLDBZIGSA-N
L(-)-vesamicol hydrochloride 	XJNUHVMJVWOYCW-UHFFFAOYSA-N
imatinib	KTUFNOKKBVMGRW-UHFFFAOYSA-N
tetramisole	HLFSDGLLUJUHTE-UHFFFAOYSA-N
zuclopenthixol	WFPIAZLQTJBIFN-BLLMUTORSA-N	WFPIAZLQTJBIFN-DVZOWYKESA-N	WFPIAZLQTJBIFN-UHFFFAOYSA-N
glafenine	GWOFUCIGLDBNKM-UHFFFAOYSA-N
triamterene	FNYLWPVRPXGIIP-UHFFFAOYSA-N
butacaine	HQFWVSGBVLEQGA-UHFFFAOYSA-N
ambroxol	JBDGDEWWOUBZPM-UHFFFAOYSA-N
securinine	SWZMSZQQJRKFBP-WZRBSPASSA-N	SWZMSZQQJRKFBP-UHFFFAOYSA-N	SWZMSZQQJRKFBP-ZBOXLXRLSA-N	SWZMSZQQJRKFBP-KKPNGEORSA-N	SWZMSZQQJRKFBP-ZNVNOEFISA-N	SWZMSZQQJRKFBP-GMXVVIOVSA-N
mebeverine	VYVKHNNGDFVQGA-UHFFFAOYSA-N
alvespimycin	KUFRQPKVAWMTJO-LMZWQJSESA-N
(+/-)-catechin	
0317956-0000	
ursolic_acid	
isradipine	HMJIYCCIJYRONP-UHFFFAOYSA-N
Y-27632	IYOZTVGMEWJPKR-VOMCLLRMSA-N
carisoprodol	OFZCIYFFPZCNJE-UHFFFAOYSA-N
mesalazine	KBOPZPXVLCULAV-UHFFFAOYSA-N
metrizamide	BAQCROVBDNBEEB-UBLAARQISA-N	BAQCROVBDNBEEB-DFUGIZROSA-N	BAQCROVBDNBEEB-KSDLJXBFSA-N	BAQCROVBDNBEEB-OPRFMTNSSA-N	BAQCROVBDNBEEB-UBYUBLNFSA-N
PHA-00816795	GFMMXOIFOQCCGU-UHFFFAOYSA-N
quipazine	XRXDAJYKGWNHTQ-UHFFFAOYSA-N
latamoxef	JWCSIUVGFCSJCK-CAVRMKNVSA-N
acepromazine	NOSIYYJFMPDDSA-UHFFFAOYSA-N
estrone	DNXHEGUUPJUMQT-CBZIJGRNSA-N
prenylamine	IFFPICMESYHZPQ-UHFFFAOYSA-N
0179445-0000	
ethosuximide	HAPOVYFOVVWLRS-UHFFFAOYSA-N
Tadjakonine 	MXDMNWAHROTMFX-JUGBYXHMSA-N
chlorphenesin	MXOAEAUPQDYUQM-UHFFFAOYSA-N
harpagoside	KVRQGMOSZKPBNS-FMHLWDFHSA-N
lisinopril	RLAWWYSOJDYHDC-BZSNNMDCSA-N
serotonin	QZAYGJVTTNCVMB-UHFFFAOYSA-N
iopamidol	XQZXYNRDCRIARQ-LURJTMIESA-N
rilmenidine	CQXADFVORZEARL-UHFFFAOYSA-N
cefotetan	SRZNHPXWXCNNDU-RHBCBLIFSA-N
progesterone	RJKFOVLPORLFTN-LEKSSAKUSA-N
butirosin	XEQLFNPSYWZPOW-NUOYRARPSA-N
irinotecan	UWKQSNNFCGGAFS-XIFFEERXSA-N
spiramycin	ACTOXUHEUCPTEW-JMRHEKERSA-N	ACTOXUHEUCPTEW-DWDMVGJGSA-N	ACTOXUHEUCPTEW-KWBWCIJSSA-N	ACTOXUHEUCPTEW-OBURPCBNSA-N	ACTOXUHEUCPTEW-UHFFFAOYSA-N	ACTOXUHEUCPTEW-JNQYENBPSA-N	ACTOXUHEUCPTEW-BOISPSKTSA-N	ACTOXUHEUCPTEW-BWHGAVFKSA-N	ACTOXUHEUCPTEW-HRAVRIHDSA-N	ACTOXUHEUCPTEW-IMDCDJEBSA-N
nadolol	VWPOSFSPZNDTMJ-UCWKZMIHSA-N
trimethoprim	IEDVJHCEMCRBQM-UHFFFAOYSA-N
fluocinonide	WJOHZNCJWYWUJD-IUGZLZTKSA-N
rotenone	JUVIOZPCNVVQFO-HBGVWJBISA-N
remoxipride	GUJRSXAPGDDABA-NSHDSACASA-N
tetracycline	NWXMGUDVXFXRIG-WESIUVDSSA-N
mexiletine	VLPIATFUUWWMKC-UHFFFAOYSA-N
riluzole	FTALBRSUTCGOEG-UHFFFAOYSA-N
moroxydine	KJHOZAZQWVKILO-UHFFFAOYSA-N
chrysin	RTIXKCRFFJGDFG-UHFFFAOYSA-N
sulfamerazine	QPPBRPIAZZHUNT-UHFFFAOYSA-N
withaferin_A	
bacampicillin	PFOLLRNADZZWEX-FFGRCDKISA-N
nabumetone	BLXXJMDCKKHMKV-UHFFFAOYSA-N
tranexamic_acid	
atropine_oxide	
gibberellic_acid	
scriptaid	JTDYUFSDZATMKU-UHFFFAOYSA-N
amphotericin_B	
AG-013608	MJYSTAROWSLRAN-UHFFFAOYSA-N
niflumic_acid	
dicycloverine	CURUTKGFNZGFSE-UHFFFAOYSA-N
azacitidine	NMUSYJAQQFHJEW-KVTDHHQDSA-N
clemizole	CJXAEXPPLWQRFR-UHFFFAOYSA-N
tinidazole	HJLSLZFTEKNLFI-UHFFFAOYSA-N
cefotiam	QYQDKDWGWDOFFU-IUODEOHRSA-N
mesoridazine	SLVMESMUVMCQIY-UHFFFAOYSA-N
pempidine	XULIXFLCVXWHRF-UHFFFAOYSA-N
monobenzone	VYQNWZOUAUKGHI-UHFFFAOYSA-N
bromocriptine	OZVBMTJYIDMWIL-AYFBDAFISA-N
valinomycin	FCFNRCROJUBPLU-DNDCDFAISA-N	FCFNRCROJUBPLU-RPUZOQEISA-N	FCFNRCROJUBPLU-GXCNOZDHSA-N	FCFNRCROJUBPLU-GGUWDUSBSA-N	FCFNRCROJUBPLU-UYBNATROSA-N	FCFNRCROJUBPLU-UHFFFAOYSA-N
5194442	
carcinine	ANRUJJLGVODXIK-UHFFFAOYSA-N
mafenide	TYMRLRRVMHJFTF-UHFFFAOYSA-N
isoflupredone	WAIJIHDWAKJCBX-QVABZINDSA-N	WAIJIHDWAKJCBX-BULBTXNYSA-N	WAIJIHDWAKJCBX-UHFFFAOYSA-N	WAIJIHDWAKJCBX-OJOIFHBDSA-N
5666823	
(-)-MK-801	QLTXKCWMEZIHBJ-CXGSIYSVSA-N
merbromin	KQSRXDXJGUJRKE-UHFFFAOYSA-L	KQSRXDXJGUJRKE-UHFFFAOYSA-L	QJJYLIJNUFJILQ-UHFFFAOYSA-N	FBIOKVUHDNAAPP-UHFFFAOYSA-L
colecalciferol	QYSXJUFSXHHAJI-QWSSABAFSA-N	QYSXJUFSXHHAJI-FVUVGDFOSA-N	QYSXJUFSXHHAJI-WRUPMXQZSA-N	QYSXJUFSXHHAJI-RWDMXNMGSA-N	QYSXJUFSXHHAJI-YRZJJWOYSA-N
sodium_phenylbutyrate	
10-methoxyharmalan	PIRYBCJVLMHZOK-UHFFFAOYSA-N
oxamniquine	XCGYUJZMCCFSRP-UHFFFAOYSA-N
primaquine	INDBQLZJXZLFIT-UHFFFAOYSA-N
diperodon	YUGZHQHSNYIFLG-UHFFFAOYSA-N
chlorhexidine	GHXZTYHSJHQHIJ-UHFFFAOYSA-N
celecoxib	RZEKVGVHFLEQIL-UHFFFAOYSA-N
chlormezanone	WEQAYVWKMWHEJO-UHFFFAOYSA-N
mianserin	UEQUQVLFIPOEMF-UHFFFAOYSA-N
tetryzoline	BYJAVTDNIXVSPW-UHFFFAOYSA-N
PHA-00851261E	IVDMJLJBDZJMRY-UHFFFAOYSA-N
ethaverine	ZOWYFYXTIWQBEP-UHFFFAOYSA-N
3-acetylcoumarin	CSPIFKKOBWYOEX-UHFFFAOYSA-N
STOCK1N-35215	TXJZRSRTYPUYRW-GHTZIAJQSA-N
quinidine	LOUPRKONTZGTKE-LHHVKLHASA-N
pyrithyldione	NZASCBIBXNPDMH-UHFFFAOYSA-N
nitrofural	IAIWVQXQOWNYOU-FPYGCLRLSA-N
bucladesine	CJGYSWNGNKCJSB-YVLZZHOMSA-N	MBIUSAASWSOYGU-VMZSDVDQSA-M	KRBZRVBLIUDQNG-JBVYASIDSA-M
sulfanilamide	FDDDEECHVMSUSB-UHFFFAOYSA-N
STOCK1N-35874	UXPVXDMDIUSMEC-UHFFFAOYSA-N
kawain	XEAQIWGXBXCYFX-GUOLPTJISA-N
tamoxifen	NKANXQFJJICGDU-QPLCGJKRSA-N
metoclopramide	TTWJBBZEZQICBI-UHFFFAOYSA-N
ifosfamide	HOMGKSMUEGBAAB-UHFFFAOYSA-N
Nitrarine dihydrochloride 	AJFJKGLXKPEJMU-UHFFFAOYSA-N
nitrendipine	PVHUJELLJLJGLN-UHFFFAOYSA-N
picrotoxinin	PIMZUZSSNYHVCU-YKWPQBAZSA-N	PIMZUZSSNYHVCU-LRQBLGHVSA-N	PIMZUZSSNYHVCU-IQPPENEWSA-N	PIMZUZSSNYHVCU-KBLUICEQSA-N	PIMZUZSSNYHVCU-UHFFFAOYSA-N
trimetazidine	UHWVSEOVJBQKBE-UHFFFAOYSA-N
scopolamine	STECJAGHUSJQJN-YXPYLGEYSA-N	STECJAGHUSJQJN-PMFPHFEJSA-N	STECJAGHUSJQJN-OYVHKFOJSA-N	STECJAGHUSJQJN-YOHVKPHQSA-N	STECJAGHUSJQJN-USLFZFAMSA-N	STECJAGHUSJQJN-UHFFFAOYSA-N	STECJAGHUSJQJN-MKXJHAPZSA-N	STECJAGHUSJQJN-SFSMXDMGSA-N	STECJAGHUSJQJN-YXMSTPNBSA-N
clofazimine	WDQPAMHFFCXSNU-UHFFFAOYSA-N
galantamine	ASUTZQLVASHGKV-JDFRZJQESA-N
cantharidin	DHZBEENLJMYSHQ-OBDNUKKESA-N	DHZBEENLJMYSHQ-XCVPVQRUSA-N	DHZBEENLJMYSHQ-UHFFFAOYSA-N	DHZBEENLJMYSHQ-MLTZYSBQSA-N
benzbromarone	WHQCHUCQKNIQEC-UHFFFAOYSA-N
hydrastinine	YOJQZPVUNUQTDF-UHFFFAOYSA-N
pioglitazone	HYAFETHFCAUJAY-UHFFFAOYSA-N
metergoline	WZHJKEUHNJHDLS-QTGUNEKASA-N
tiaprofenic_acid	
difenidol	OGAKLTJNUQRZJU-UHFFFAOYSA-N
lumicolchicine	VKPVZFOUXUQJMW-FHSNZYRGSA-N	VKPVZFOUXUQJMW-JCGVRSQUSA-N	VKPVZFOUXUQJMW-UHFFFAOYSA-N
colforsin	OHCQJHSOBUTRHG-KGGHGJDLSA-N
sulfachlorpyridazine	XOXHILFPRYWFOD-UHFFFAOYSA-N
oxytetracycline	OWFJMIVZYSDULZ-PXOLEDIWSA-N
urapidil	ICMGLRUYEQNHPF-UHFFFAOYSA-N
hydrocortisone	JYGXADMDTFJGBT-VWUMJDOOSA-N
prochlorperazine	WIKYUJGCLQQFNW-UHFFFAOYSA-N
nicardipine	ZBBHBTPTTSWHBA-UHFFFAOYSA-N
3-nitropropionic_acid	
5230742	
sulfathiazole	JNMRHUJNCSQMMB-UHFFFAOYSA-N
mercaptopurine	GLVAUDGFNGKCSF-UHFFFAOYSA-N
famprofazone	GNUXVOXXWGNPIV-UHFFFAOYSA-N
raubasine	GRTOGORTSDXSFK-XJTZBENFSA-N	YWPZOTNKHMBWPD-QAWKRFFXSA-N
nifuroxazide	YCWSUKQGVSGXJO-NTUHNPAUSA-N
proguanil	SSOLNOMRVKKSON-UHFFFAOYSA-N
biperiden	YSXKPIUOCJLQIE-UHFFFAOYSA-N
neomycin	PGBHMTALBVVCIT-VCIWKGPPSA-N
pyrantel	YSAUAVHXTIETRK-AATRIKPKSA-N
nisoxetine	ITJNARMNRKSWTA-UHFFFAOYSA-N
pseudopelletierine	RHWSKVCZXBAWLZ-UHFFFAOYSA-N
myosmine	DPNGWXJMIILTBS-UHFFFAOYSA-N
geldanamycin	QTQAWLPCGQOSGP-GBTDJJJQSA-N	QTQAWLPCGQOSGP-DVKIRIBLSA-N	QTQAWLPCGQOSGP-QZJJZKHZSA-N	QTQAWLPCGQOSGP-NOWWHHBVSA-N	QTQAWLPCGQOSGP-SMLPPETDSA-N	QTQAWLPCGQOSGP-NXSHVLOTSA-N	QTQAWLPCGQOSGP-UHFFFAOYSA-N	QTQAWLPCGQOSGP-PHLMVCJGSA-N	QTQAWLPCGQOSGP-KSRBKZBZSA-N	QTQAWLPCGQOSGP-RREWJJLESA-N	QTQAWLPCGQOSGP-PZFDIWMTSA-N	QTQAWLPCGQOSGP-VKNBREQOSA-N	QTQAWLPCGQOSGP-JSGVWQOWSA-N	QTQAWLPCGQOSGP-JNTUZXSDSA-N
orciprenaline	LMOINURANNBYCM-UHFFFAOYSA-N
nifenazone	BRZANEXCSZCZCI-UHFFFAOYSA-N
diphenhydramine	ZZVUWRFHKOJYTH-UHFFFAOYSA-N
benzonatate	MAFMQEKGGFWBAB-UHFFFAOYSA-N
calmidazolium	UXUADFHIUMKSLB-UHFFFAOYSA-N	COYSNGXBLIDKRR-UHFFFAOYSA-M	YGEIMSMISRCBFF-UHFFFAOYSA-M	CTKNMSVWMRRCPW-UHFFFAOYSA-N
mecamylamine	IMYZQPCYWPFTAG-UHFFFAOYSA-N
disulfiram	AUZONCFQVSMFAP-UHFFFAOYSA-N
guaifenesin	HSRJKNPTNIJEKV-UHFFFAOYSA-N
beta- Belladonnine dichloroethylate 	HPWIBMJBDHQVMC-SRASDCGWSA-L
proglumide	DGMKFQYCZXERLX-UHFFFAOYSA-N
flufenamic_acid	
ozagrel	SHZKQBHERIJWAO-AATRIKPKSA-N
clonidine	GJSURZIOUXUGAL-UHFFFAOYSA-N
levopropoxyphene	XLMALTXPSGQGBX-PGRDOPGGSA-N	XLMALTXPSGQGBX-UHFFFAOYSA-N	XLMALTXPSGQGBX-XMSQKQJNSA-N	XLMALTXPSGQGBX-GCJKJVERSA-N
suxibuzone	ONWXNHPOAGOMTG-UHFFFAOYSA-N
methylprednisolone	VHRSUDSXCMQTMA-PJHHCJLFSA-N
flucytosine	XRECTZIEBJDKEO-UHFFFAOYSA-N
11-deoxy-16,16-dimethylprostaglandin_E2	
oxolinic_acid	
mepacrine	GPKJTRJOBQGKQK-UHFFFAOYSA-N
cyproheptadine	JJCFRYNCJDLXIK-UHFFFAOYSA-N
sulfamonomethoxine	WMPXPUYPYQKQCX-UHFFFAOYSA-N
genistein	TZBJGXHYKVUXJN-UHFFFAOYSA-N
metamizole_sodium	
halofantrine	FOHHNHSLJDZUGQ-UHFFFAOYSA-N
acetylsalicylic_acid	
naproxen	CMWTZPSULFXXJA-VIFPVBQESA-N
deferoxamine	UBQYURCVBFRUQT-UHFFFAOYSA-N
ciclacillin	HGBLNBBNRORJKI-WCABBAIRSA-N
streptozocin	ZSJLQEPLLKMAKR-GKHCUFPYSA-N
chlorpropamide	RKWGIWYCVPQPMF-UHFFFAOYSA-N
CAY-10397	YYBSDOZYJSGLTH-UHFFFAOYSA-N
dapsone	MQJKPEGWNLWLTK-UHFFFAOYSA-N
fluoxetine	RTHCYVBBDHJXIQ-UHFFFAOYSA-N
aminoglutethimide	ROBVIMPUHSLWNV-UHFFFAOYSA-N
phenacetin	CPJSUEIXXCENMM-UHFFFAOYSA-N
hexestrol	PBBGSZCBWVPOOL-UHFFFAOYSA-N
trapidil	GSNOZLZNQMLSKJ-UHFFFAOYSA-N
DO 897/99	
flumequine	DPSPPJIUMHPXMA-UHFFFAOYSA-N
alprostadil	GMVPRGQOIOIIMI-DWKJAMRDSA-N
doxycycline	SGKRLCUYIXIAHR-AKNGSSGZSA-N
corbadrine	GEFQWZLICWMTKF-CDUCUWFYSA-N
verapamil	SGTNSNPWRIOYBX-UHFFFAOYSA-N
fenoprofen	RDJGLLICXDHJDY-UHFFFAOYSA-N
lovastatin	PCZOHLXUXFIOCF-BXMDZJJMSA-N
bromopride	GIYAQDDTCWHPPL-UHFFFAOYSA-N
butein	AYMYWHCQALZEGT-ORCRQEGFSA-N
harmaline	QJOZJXNKVMFAET-UHFFFAOYSA-N
3-aminobenzamide	GSCPDZHWVNUUFI-UHFFFAOYSA-N
estradiol	VOXZDWNPVJITMN-ZBRFXRBCSA-N
metacycline	XIYOPDCBBDCGOE-IWVLMIASSA-N
Methylhydantoin-5-(L) 	VMAQYKGITHDWKL-REOHCLBHSA-N
diethylcarbamazine	RCKMWOKWVGPNJF-UHFFFAOYSA-N
NU-1025	YJDAOHJWLUNFLX-UHFFFAOYSA-N
aceclofenac	MNIPYSSQXLZQLJ-UHFFFAOYSA-N
lisuride	BKRGVLQUQGGVSM-KBXCAEBGSA-N
kaempferol	IYRMWMYZSQPJKC-UHFFFAOYSA-N
ofloxacin	GSDSWSVVBLHKDQ-UHFFFAOYSA-N
levcycloserine	DYDCUQKUCUHJBH-UHFFFAOYSA-N
netilmicin	CIDUJQMULVCIBT-MQDUPKMGSA-N	CIDUJQMULVCIBT-KALHTFJLSA-N	CIDUJQMULVCIBT-UHFFFAOYSA-N
bicuculline	IYGYMKDQCDOMRE-ZWKOTPCHSA-N
fluorocurarine	ZEMNDQUOMWGCAZ-CVPVZSHVSA-O
baclofen	KPYSYYIEGFHWSV-UHFFFAOYSA-N
dicoumarol	DOBMPNYZJYQDGZ-UHFFFAOYSA-N
esculin	XHCADAYNFIFUHF-DJIJKHNZSA-N	XHCADAYNFIFUHF-TVKJYDDYSA-N	XHCADAYNFIFUHF-UHFFFAOYSA-N	XHCADAYNFIFUHF-WDJGLXJESA-N
tetrandrine	WVTKBKWTSCPRNU-KYJUHHDHSA-N
exisulind	MVGSNCBCUWPVDA-MFOYZWKCSA-N
N-acetyl-L-aspartic_acid	
econazole	LEZWWPYKPKIXLL-UHFFFAOYSA-N
alpha-estradiol	VOXZDWNPVJITMN-SFFUCWETSA-N
emetine	AUVVAXYIELKVAI-CKBKHPSWSA-N
chlorambucil	JCKYGMPEJWAADB-UHFFFAOYSA-N
atropine	RKUNBYITZUJHSG-PJPHBNEVSA-N
ethoxyquin	DECIPOUIJURFOJ-UHFFFAOYSA-N
pargyline	DPWPWRLQFGFJFI-UHFFFAOYSA-N
vorinostat	WAEXFXRVDQXREF-UHFFFAOYSA-N
oxymetazoline	WYWIFABBXFUGLM-UHFFFAOYSA-N
nifurtimox	ARFHIAQFJWUCFH-IZZDOVSWSA-N
